Peking Duck Wrapper--->鸭饼皮
Peking Duck Condiments Set--->片皮鸭配料组合
NESTLE CHOCOLATE DRUMSTICK--->雀巢巧克力甜筒
MISO SHIRO W/O MSG. GMO HANAMARUKI--->信州无味精白味噌
Itoen Green Tea--->伊藤园浓味绿茶
Gaylea Butter Salted--->有盐牛油
Hime Green Tea Ice Cream--->姬绿茶雪糕
H.M.Sausage Combo--->合利精美腊味包
K. J. Foods Soup Filled Steamed Pork Bun--->华洪 小笼麭
Sun On Shanghai Style Noodles-Round--->新安上海面- 圆
SUN ON WONTON WRAPPERS--->新安 云吞皮（馄饨皮）
Unique Wonto Shrimp Chicken & Pork Wonto--->唯一 三鲜云吞
WING HING EGG TOFU--->永兴玉子豆腐
Hohoho Fried Fish Ball--->好好好炸鱼蛋
I-MEI FROZEN WAFFLE W/GREEN ONION--->义美葱油饼
ITOEN ROASTED GREEN TEA--->伊藤园绿茶
Royal Bbq Bean Curd Pork--->金冠东莞南乳肠
Royal Bbq Duck Liver--->金冠鲜鸭润肠
Ten Ten Shang Dong Big Bun--->天天山东大馒头
An Ching Peanut Rice Ball--->安井宁波花生汤圆
Unique Leek & Shrimp Wonton--->唯一韭菜鲜虾云吞
Myojo Nama Yakisoba- Curry--->明星酱烧炒面咖喱
Coconut Cream Bun--->椰丝奶油包
Ufc Coconut Water--->UFC 椰子水
Fiji Artesian Water--->斐济深层矿泉水
Dr.Jart Vital Hydra Solution--->Dr.Jart深层水润面膜
Ryoe Anti-Aging Total Care Set--->吕逆龄洗护套组
SHISEIDO TSUBAKI NEW SMOOTH SHAMPOO--->资生堂思波绮植萃瞬透柔顺洗发水
DSH BLACK FUNGUS WHOLE--->大山合东北黑木耳
ITO KANTO 18CM SAUCE POT--->ITO KANTO 18CM SAUCE POT
Lppz Garlic Scallop Snack--->良品铺子蒜香虾夷扇贝
Nongshim Seafood Cup Noodle--->农心海鲜杯面
Taisun Mixed Congee--->泰山八宝粥
ITOEN GOLDEN OOLONG TEA--->ITOEN GOLDEN OOLONG TEA
NO NAME FOAM BOWLS--->NO NAME FOAM BOWLS
NO NAME FREEZER BAG--->NO NAME FREEZER BAG
YOSHIKAWA MULTIFUNCTN POT 22CM--->YOSHIKAWA MULTIFUNCTN POT 22CM
PORTO FRYPAN--->PORTO FRYPAN
WUJIANG PRESERVED VEGETABLE--->WUJIANG PRESERVED VEGETABLE
T&T FIVE SPICE POWDER--->T&T五香粉
Hq Ultrasonic Humidifier-2.8 L--->HQ音波加湿器-2.8升
T&T Mixed Congee W/Brown Sugar--->T&T黑糖八宝粥
JM PLACEN HORSE PURE MASK--->JM胎盘素马脂面膜
MARUTO BANANA CHOCO CAKE--->丸卜香蕉白巧蛋糕
ORION CHOCO PIE--->好丽友巧克力派-30P
AKAI BOHSHI ASSORTED COOKIES PINK BOX--->日本红帽雅致粉红礼盒
BOURBON HIGH SELECTION GIFT SET--->波本精选饼干礼盒
Sausage Bun--->肠仔饱
Wintermelon Pastry-6Pcs--->台式迷你老婆饼-6件
HAAGEN-DAZS ICE CREAM-SWISS ALMOND--->HD瑞士杏仁雪糕
TROPICANA PURE ORANGE JUICE HOMESTYLE-WITH PULP--->TROP纯橙汁家庭式-有果肉
NISSUI FISH SAUSAGE -3PCS--->日水鱼肠-3条装
Ocean Mama Brand Frozen Whole Clams--->冻煮花蛤
WATSON HANDMADE SLICED NOODLES--->华生刀削面
NANXIANG DRIED PICKLED VEGETABLE BUN--->南翔梅干菜包
Lemon Egg Yolk Cake--->柠檬虎皮蛋糕
Maple Leaf Salt Reduced Bacon--->枫叶低盐烟肉
MAPLE LEAF LAZY MAPLE BACON--->枫叶枫糖烟肉
Mr Fried Fish Ball--->满盛炸鱼蛋
RI WANG SOUPY BUNS W/ CRAB MEAT--->日旺蟹肉小笼汤包
Sunnymark Dried Small Shrimp--->新唛鲜味甜虾皮
Kowa Frozen Seaweed Salad--->冷冻海带沙拉即食
NEILSON TTT 2L SKIM LACTOSE/F - CTN--->NS低乳糖脱脂鲜奶
NEILSON NLS 2L ORGANIC 1% - CTN--->NS有机1%鲜奶
Neilson 10% Uht Cream--->Neilson 10%半脂奶油
BUONO ASSORTED NON DAIRY FZ DESSERT MOCH--->综合椰奶雪麻糬
Meiji Tsujiri Matcha Cone--->明治抹茶甜筒
LAO BEI JING RED DATE GLASS YOGURT 4 PAC--->老北京红枣优格
Asian Legend Shredded Pork Fried Noodle--->味香村肉丝炒面
Lotte Ice Yogurt--->乐天养乐多
HMD MINCED PORK MUSHROOM&WATER CHESTNUT--->HMD MINCED PORK MUSHROOM&WATER CHESTNUT
GODIVA GOLDMARK GIFT BOX--->歌帝梵金装欢享礼盒
MSZW CAMEMBERT CHEESE CAKE--->松泽芝士蛋糕礼盒
MEAL OF EMPEROR ABALONE XO SAUCE--->御本膳鲍鱼XO酱
701 MEDICATED PLASTER--->701跌打镇痛膏
Yeshu Coconut Drink--->椰树牌椰子汁
T&T 50% LESS SUGAR ALOE VERA DRINK--->T&T 芦荟乐(半糖)
Zhangxiaoquan Knife Scissors 3Pcs Set--->张小泉刀剪三件套
Chaokoh 100% Coconut Water--->秋菊椰子水
Itoen Jasmine Tea--->伊藤园茉莉花茶
MASTERKON GREEN TEA--->康师傅绿茶
Zoji Elec Water Kettle Cd-Jwc30hs 3L--->象印电热水壶3L
BUENAS MACAPUNO STRINGS--->BUENAS MACAPUNO STRINGS
Po Chai Pills--->香港保济丸
MOGU LYCHEE NATA DE COCO JUICE--->MOGU LYCHEE NATA DE COCO JUICE
NFSQ GRAPEFRUIT ROSE LYCHEE TEA--->NFSQ GRAPEFRUIT ROSE LYCHEE TEA
YDD DRIED GUM TRAGACANTH--->YDD DRIED GUM TRAGACANTH
KINGBRINE CUMIN CRAB STICK--->金渤孜然手撕蟹肉棒
BAIJIA HOT&SOUR CHONGQING NOODLE 5 PACKS--->白家酸辣重庆小面
AKAI BOHSHI ASSORTED COOKIES GOLD BOX--->日本红帽鎏金礼盒
AKAI BOHSHI ASSORTED COOKIES RED BOX--->日本红帽宝石红礼盒
CEMOI CLASSIC TRUFFES BALLOTIN--->经典法式巧克力
SHOEI TOKYO BANANA CAKE GIFT BOX--->素伊东京香蕉蛋糕礼盒
KUKKIA ASSORTED COOKIES(12PC)--->红帽综合法兰酥12
KWAN LOONG OIL--->均隆驱风油
Rimao Bamboo Shoot--->日茂桂竹笋
Tenten Brown Sugar Flour Bun--->天天红糖馒头
Buono Seasame Non-Dairy Fz Mochi--->BUONO芝麻麻糬
Long Feng Frozen Tofu--->台湾龙凤冻豆腐
ASIAN LEGEND FRIED RICE W/ SHRIMPS & EGGS--->味香村虾仁蛋炒饭
Nissin Glutinous Rice Dumpling--->日清鲍汁味珍珠鸡
FOOD FOR YOU LARGE THE KIMCHI--->FOOD 4 U泡菜大
Sunshine Ranch Sliced Lamb Roll--->阳光牧场羊五花
LAO BEIJING GLASS JAR YOGURT - PLAIN--->老北京玻璃瓶优格
YAA FANG RB&MATCH LATE ICE DESSRT--->雅方红豆抹茶雪糕
Black Angus Beef Slice--->黑安格斯肥牛片
Northern Food Hot Pot Soya Beancurd Strips--->丰业火锅干丝
ZHU LAO DA JUICY PORK&MUSHROOM DUMPLING--->朱老大汤肉香菇饺
FOONG KITCHEN SOY BEAN ROLL--->丰师傅火锅腐皮卷
Avocado-Large--->牛油果-大
BAGUIO LONGANISA(REG)--->菲式香肠-原味
Amoy Fish Shaomai--->淘大鱼肉烧卖
TYJ SPRING ROLL PASTRY 8IN--->第一家春卷皮8IN
President Choice Bacon-50% Less Salt--->PC 低盐培根
Sweet&Sour Pork Bento Box--->菠萝甜酸咕噜肉便当
Umami Gold Needle Fish--->鲜味金针鱼
You-Choy--->油菜
You Choy-Jr.--->油菜苗
Hazelnut Lava Cake--->榛果流心蛋糕
PALDO SOY FLAVOR NOODLE 5PK--->八道御膳味噌拉面
LITTLE SHEEP SPICY HOTPOT SOUP BASE--->小肥羊麻辣火锅料
JULIANG MATSUTAKE--->巨量松茸
Kirin Milk Tea--->午後红茶奶茶
Tung-I Milk Tea--->统一麦香奶茶
LAONIE PRUNE DRINK--->老聂川记乌梅汁
GARDEN LEMON CREAM SANDWICH BISCUIT--->嘉顿柠檬夹心
HUNG FOOK TONG COMMON SELFHEAL FRUIT SPIKE DRINK--->鸿福堂夏枯草
TZP COCONUT JUICE--->特种兵生榨椰子汁
T&T Mixed Congee Dessert--->T&T 八宝粥
SKYFLAKES CRACKERS(TUB)--->空中霸王餅(盒裝)800G
YESHU COCONUT TREE COCONUT DRINK--->椰树椰汁
Vita Original Soyamilk--->维他奶
Glico Pocky Chocolate Biscuit Stick--->固力果朱古力百奇
ARIZONA GREEN TEA--->阿里桑娜绿茶
DSH DRIED LOTUS SEED--->DSH DRIED LOTUS SEED
UJINOTSUYU JAPANESE SENCHA GREEN TEA BAG--->UJINOTSUYU JAPANESE SENCHA GREEN TEA BAG
T&T SILVER DAMIER CHOPSTICK--->T&T SILVER DAMIER CHOPSTICK
T&T GOLDEN DAMIER CHOPSTICK--->T&T GOLDEN DAMIER CHOPSTICK
OS SPLIT DRIED SEA CUCUMBER--->OS SPLIT DRIED SEA CUCUMBER
Enjoy Chenhua Soy Sauce Bamboo--->食在辰华上海油焖笋
KAO Bubble HAIR COLOR NEW YORK ASH--->KAO Bubble HAIR COLOR NEW YORK ASH
Cure Natural Aqua Gel--->CURE温和去角质凝胶
NATURA ORGANIC SOY - ORIGINAL--->NATURA豆奶-原味
Mini Wintermelon Pastry-6Pcs--->港式老婆饼（小）6PCS
Egg Tart-6Pcs (Cold)--->酥皮蛋塔-6件(冷)
Sushi Party Tray Special--->特选优惠寿司拼盘
Mini Coconut Tart--->迷你椰塔8件
Fruit Tart--->新鲜果塔
Ferma Fz Sardines--->沙丁鱼
Frozen Baby Octopus--->冷冻小章鱼
Black Angus Beef Rolls--->美国黑安格斯牛肉卷
Tc Fz Cooked Marinated Abalone W/ Shell--->顶厨日式即食鲍鱼
Sweet Orange--->甜橙-大
I-Mei Panda Ice Cream Bar--->义美猫熊雪糕
SEARAY LOBSTER STYLE BALL--->海威龙虾丸
DANONE STRAWBERRY BANANA--->达能草莓香蕉优酪饮
OWL STIR FRIED BEEF W/ RICE--->猫头鹰韩烧牛肉饭
LBJ BLUEBRY LAVENDER GLASSJAR YOGURT 4S--->老北京蓝莓优格
HAN-KA CUT CABBAGE KIMCHI LARGE--->韩家韩国泡菜-大
Green Onion Dry Pork Bun--->葱花肉松小餐包
Japanese Honey Cake-6 Pcs--->日式蜂蜜蛋糕-6
Pork Bun-4 Pcs (Cold)--->鲜肉大包-4件 (冷)
Organic Chicken Drumstick--->有机小鸡腿
Carrot24- 2Lbs--->红萝卜-袋
Unique Wonto Canton Shrimp Wonton--->唯一广东鲜虾云吞
Chongga Kimchi Cut Cabbage--->宗家韩国泡菜- 小
Northern Food Beancurd Sheet--->丰业干豆腐皮
Kao Gentle Steam Eye Mask--->花王四季限定组合装
MOEGINO ASSORTED CHOCOLATE COOKIES 24P--->千本夹心酥礼盒24枚
ORION SEAWEED FLAVOURED CRACKER-15P--->好丽友海苔好多鱼饼
MXX SOUR SOUP SELF HEATING HOT POT--->莫小仙酸汤自热火锅
AKAI BOHSHI ASSORTED COOKIES ELEGANT PIN--->日本红帽宠爱粉礼盒
SKII TREATMENT ESSENCE+RNA--->SKII神仙水送大红瓶霜
Kao Bubble Color Dark Navy--->花王泡泡染发雾霾蓝
JFL DRIED RED DATES--->JFL DRIED RED DATES
Lppz Spicy Scallop Snack--->良品铺子香辣虾夷扇贝
Lppz Spicy Shrimp Snack--->良品铺子香辣对对虾
OISHI KIREI FLAKES-SHRIMP FLV--->OISHI KIREI FLAKES-SHRIMP FLV
KAO BUBBLE HAIR COLOR BRITISH ASH--->KAO BUBBLE HAIR COLOR BRITISH ASH
HE WANG WALNUT CAKE--->HE WANG WALNUT CAKE
TIGER TACOOK 10C RICE COOKER-W--->TIGER TACOOK 10C RICE COOKER-W
Ito En Green Tea--->伊藤园日本绿茶
Vita Lemon Tea--->维他柠檬茶
Ito En Koiaji Ryokucha Green Tea--->伊藤园特浓绿茶
HUNG FOOK TONG IMPERATAE CANE DRINK--->鸿福堂竹蔗茅根
AOMORI 100% APPLE JUICE--->青森百分百苹果汁
I-MEI PLUM DRINK--->义美酸梅汤
Nongshim Shin Cup Noodle--->农心乌龙杯面-辛
HUNG FOOK TONG SOUR PLUM DRINK--->鸿福堂酸梅汤
AROY-D LONGAN IN SYRUP--->阿罗地糖水龙眼
SALONPAS--->撒隆巴斯
Organic King Oyster Mushroom-Baby--->有机杏鲍菇皇-小
100% Jumbo Shrimp Dumpling--->百份百大虾广东水饺
Mandarin Egg Tofu--->中华玉子蛋豆腐
Sunshine Fz Durian Pulp--->冷冻金枕头榴槤肉
Frozen Abalone--->急冻鲍鱼
NEILSON NLS 2L ORGANIC 2% - CTN--->NS有机2%鲜奶
Fz. Squid Carving--->急冻鱿鱼花
C.J. BEEF&VEGETABLE BIG DUMPLINGS--->C.J.韩式牛肉菜饺
T&T Gyoza - Beef, Pork & Vegetables--->T&T日式煎饺
T&T Sliced Rice Cakes--->T&T年糕片
Frozen Cooked Scallops W/ Garlic Vermicelli--->蒜茸粉丝扇贝
Chive Pork Dumpling (Raw)--->韭菜猪肉饺(生)
T&T Taiwan Style Sausage Garlic--->T&T台式香肠(蒜味)
Cilantro--->莞茜/香菜
North Shore Fishery Hot&Spicy Cooked Crayfish--->北洋海产麻辣小龙虾
Gold Kiwifruit (Box)--->黄金奇异果(盒)
LONGANISA (REG) BULACAN--->菲式香肠-原味
Sun On Steamed Egg Noodles--->营养鲜蛋炒面
Searay Fish Puff Mushroom--->海威香菇豆腐
ASIAN LEGEND ASIAN STYLE THICK NOODLE--->味香村粗面
Soy Bean Sprout--->黄豆芽
Sesame Crisps--->芝麻香片
TROPICS SKINLESS SWEET PORK LONGANISA--->TROP去皮甜味肉肠
TIANHE GU TONG TIE GAO--->天和骨通贴膏
Vita Ceylon Lemon Tea--->维他锡兰柠檬茶
MASTERKON JASMINE HERBAL GREEN TEA--->康师傅茉莉蜜茶
MINUTE MAID. ORANGE JUICE--->美之源果粒橙果汁
COCA-COLA FIBER+--->COCA-COLA FIBER+
VT CICA MILD FOAM CLEANSER--->VT CICA MILD FOAM CLEANSER
Tiger Micom Rice Cooker Japan Made--->虎牌电锅JBV-S10U
T&T BLACK PEPPER POWDER--->T&T黑胡椒粉
T&T CUMIN POWDER--->T&T孜然粉
BJ SPICY FEI-CHANG VERMICELLI FAMILY PK--->白家辣肥肠味粉丝
AKAI BOHSHI NATTIA 21PCS ASSORTED COOKIE--->红帽坚果叶形酥礼盒
AKAI BOHSHI NATTIA 32PCS ASSORTED COOKIE--->红帽坚果叶形酥礼盒
KAO PRETTIA BUBBLE COLOR- DARK CHOCOLATE--->花王泡泡染- 深咖
EVERLAND ORGANIC GOJI BERRIES--->EVERLAND有机枸杞
Mengniu Milk-Strawberry Flvavour--->蒙牛真果粒-草莓口味
Mengniu Milk-Blueberry Flavour--->蒙牛真果粒-蓝莓口味
Hao Huan Luo Spicy Crayfish Rice Noodle--->好欢螺小龙虾味螺狮粉
The Saem Jeju 99 Aloe Vera Gel-L--->迪赛99芦荟凝胶-加量
CAMPBELL BEEF BROTH TETRA--->CAMPBELL BEEF BROTH TETRA
NONTOXI DIAMOND COATING EGGPAN 20CM--->NONTOXI DIAMOND COATING EGGPAN 20CM
KUANG CHUAN TEA TIME ASSAM MILK TEA--->KUANG CHUAN TEA TIME ASSAM MILK TEA
AJINOMOTO CUP CORN INST SOUP--->AJINOMOTO CUP CORN INST SOUP
Paldo Aloe Drink--->八道芦荟宝
Paldo Sugar Free Aloe Drink--->八道健美芦荟宝
SYNEAR BLACK SESAME PASTE RICE BALL--->SYNEAR BLACK SESAME PASTE RICE BALL
Bdmp Dried Shrimp Ck L--->BDMP虾米CK L
Morinaga Vienetta Vanilla--->森永香草雪糕蛋糕
SAKURA TALWANESE STYLE PORK SAUSAGE--->樱花安康猪台湾香肠
Silky Cream Puff-Mango, 6 Pcs--->丝绒泡芙-芒果, 6入装
Live Dungeness Crab-Large--->生猛游水大蟹
T&T Pork W/Shrimp Dumplings--->T&T三鲜灌汤水饺
Golden Dragon Sushi Roll--->火龙卷
Jumbo Deluxe Unagi Sushi Set--->霸王鳗鱼寿司组
Hanazen Japanese Style Sliced Chashu--->日式风味叉烧肉
Imuraya Red Bean & Mochi Ice Dessert--->井村屋红豆麻糬冰淇淋
Shepherds Purse Bun(Cold)--->荠菜包(冷)
California Sushi Roll--->加州卷
North Shore Fishery Garlic Cooked Crayfish--->北洋海产蒜香小龙虾
Deep Fried Spicy Pork Chop--->椒盐猪扒
Stir Fried Supreme Vegetable-S--->素炒杂锦蔬-小
Napoleon Chocolate Cake Roll--->拿破仑巧克力蛋糕卷
Swiss Roll - Mango--->瑞士卷- 芒果
Mini Butter Croissant--->迷你牛角包
Butter Cream Horn--->奶油忌廉筒
Coconut Roll--->椰丝卷
Glico Pocky Strawberry Biscuit Stick--->固力果草莓百奇袋
TUNG-I GREEN TEA--->统一绿茶
Nongshim Chicken Cup Noodle--->农心鸡味杯面
TUNG-I BLACK TEA--->统一麦香红茶
Lb Maple Biscuit--->枫叶饼乾
HUNG FOOK TONG CHRYSANTHEMUM & HONEY DRINK--->鸿福堂银菊露
SHISEIDO TSUBAKI NEW MOIST CONDITIONER--->资生堂思波绮植萃瞬透保湿润发乳
Chacha Coconut Sunflower Seeds--->洽洽椰香瓜子
RYOE DAMAGE CARE HAIR NOURISHING TREATMENT MASK--->吕高效修护发膜
WANT WANT VANILLA CRISP ROLL--->旺旺夹心酥卷香草
TUNG-I ASSAM BLACK MILK TEA--->统一阿萨姆奶茶
WONJIN CELL REJUVENATION MASK--->WONJIN CELL REJUVENATION MASK
ABC MANIS SWEET SOYA SAUCE--->ABC印尼甜豉油
NATURA ORGANIC SOY - UNSWEETENED--->NATURA豆奶-无糖
NATURA ORGANIC SOY - CHOCOLATE--->NATURA豆奶- 朱古力
TERRA SWEET POT PLAIN--->TERRA 紫薯薯片
Kao Gentle Stream Eye Mask--->花王布丁狗限定眼罩
KINGBRINE SPICY CRAB STICK--->金渤麻辣手撕蟹棒
WW CHEESE SENBEI RICE CRACKER FAMILY PAC--->旺旺米芝士厚脆片
MO XIAO XIAN TOMATO SELF HEATING HOT POT--->莫小仙番茄自热火锅
NAIVE BODY SOAP PUMP+REFILLSET PEACH--->嘉娜宝桃子沐浴组2S
AKAI BOHSHI ASSORTED COOKIES BLUE BOX--->日本红帽玳瑁蓝礼盒
AKAI BOHSHI ASSORTED COOKIES PURPLE BOX--->日本红帽胭脂紫礼盒
DANISA GIFT BOX--->皇冠丹麦曲奇礼盒
Multigrain Bread W/Dried Fruit--->杂粮水果软式欧包
Fish Fillet With Tomato Flavor--->番茄鱼片
100 Percent Pork Shao Mai--->百份百花菇烧卖
100 Percent Lamb Shao Mai--->百份百羊肉烧卖
100 Percent Beef Shaomai--->百份百牛肉烧卖
Chanthaburi Frozen Durian Pulp With Seed--->尚莲牌急冻有核榴槤
PORK SIRLOIN--->嫩猪瘦肉
GROUND PORK (REGULAR)--->绞猪肉
RWA PORK BELLY--->全自然五花腩
PORK BACK BONE--->猪脊骨
CHICKEN WINGETTE--->鸡中翼
DUCK WING--->鴨翼
KOREAN FRESH PORK BELLY SLICE--->韓式新鮮豬腩切片
BEEF RIB EYE SLICED(THIN)--->韩式薄切肥牛肉卷
ORGANIC PORK RIB TIP--->有機豬軟骨
LAMB SHOULDER SLICED(THIN)--->韩式薄切羊肉卷
DUCK WHOLE--->全鴨
KING MACKEREL STEAK--->新鮮馬鮫魚扒
PREVIOUS FROZEN SQUID (Previous Frozen)--->冰鲜鱿鱼
ATLANTIC SALMON HEAD--->大西洋三文鱼头
LIVE TILAPIA--->生猛游水鲫鱼
RED CABBAGE--->紅包心菜
Chayote--->合掌瓜
CHINESE WHITE RADISH--->唐萝卜/白萝卜
MARUSAN HOKKAIDO CHEESE CAKE 20PCS--->北海道起士夹心蛋糕
T&T Sakura Pattern Steel Chopstick--->T&T樱花不锈钢筷
Almas Avocado Oil Non Gmo--->ALMAS牛油果油NON GMO
Onaka 60 Tablets--->ONAKA膳食营养丸
T&T Brown Sugar Sachima Soft Pastry--->T&T黑糖沙琪玛
T&T 3In1 Milk Tea Reduced Sugar--->T&T三合一减糖奶茶
T&T Calrose Rice--->T&T圆米
T&T Sweet Rice-10Lb--->T&T美国圆糯米
T&T Screw Thread Steel Chopsticks--->T&T螺纹不锈钢筷
T&T Wheat Cutting Board-M--->T&T小麦砧板-M
T&T Wheat Cutting Board-L--->T&T小麦砧板-L
T&T Ebony Cutting Board--->T&T乌檀木圆砧板
T&T Rose Wood Cutting Board-L--->T&T蔷薇木砧板-L
T&T Rose Wood Cuttingboard-M--->T&T蔷薇木砧板-M
Lkk Sesame Oil Blended W/Soybean Oil--->李锦记混合麻油
Lee Kum Kee Mushroom Flv Dark Soy Sauce--->李锦记草菇老抽
Ryo Sensitive Hair Purple Set--->吕防脱发套装(敏感)
Dsh Hetian Red Dates 3A--->大山合四星骏枣
Heyu Honey Date--->禾煜蜜枣
Heyu Muzao Jujube--->禾煜滩枣
Master Kon Haoziwei Onion Ribs Ndle 5Pk--->好滋味葱香排骨面
Loacker Quad Lemon Wafer--->莱家柠檬粒威化
Pacific Gold Jasmine Rice--->财仔香米
Jmsolution Astaxantxin Agecaew Mask--->JM虾青素抗老面膜
Jmsolution Aqua Idebenone Egg Mask--->JM蛋清紧致淡印面膜
Jmsolution Glory Aqua Vitamin C Mask--->JM维他命C亮白面膜
Jmsolution Glory Aqua Fullerene Mask--->JM富勒烯抗氧化面膜
Lkk Premium Seasoned Soy Sauce--->李锦记天成特级鲜酱油
Lkk Supreme Seasoning Soy Suace--->李锦记醇味特级酱油
Itsuki Tokyo Yuzushoyu Ramen--->五木东京酱油拉面2人
Itsuki Kyushu Tonkotsu Ramen--->五木九州猪骨面2人
Itsuki Sapporo Miso Ramen--->五木札幌味噌拉面2人
Itsuki Osaka Tonkotsu Ramen--->五木大阪猪骨拉面2人
Lkk Selected Rice Vinegar--->李锦记9度臻选米醋
Lkk Selected Seasoned Aromatic Vinegar--->李锦记臻选调味香醋
Lkk Seasoned Mature Vinegar--->李锦记调味醇酿陈醋
Vt Cica Nutrition Mask--->VT积雪草滋养面膜
LIZIQI ORIGINAL HOT POT BASE--->李子柒清汤火锅底料
LIZIQI SPICY HOT POT BASE--->李子柒麻辣川味火锅底料
HAIDILAO SPICY SAUSAGE MICROWAVE--->海底捞川式香肠自热火锅
HAIDILAO TOMATO SAUSAGE MICROWAVE--->海底捞番茄腊肠自热火锅
HAIDILAO SPICY SAUSAGE SELFHEAT POT--->海底捞川式腊肠自热火锅
HAIDILAO TOMATO SAUSAGE SELFHEAT POT--->海底捞番茄腊肠自热火锅
HAIDILAO SPICY BEEF HOTPOT MICROWAVE--->海底捞麻辣嫩牛微波火锅
HAIDILAO TOMATO BEEF HOTPOT MICROWAVE--->海底捞番茄牛腩微波火锅
HAIDILAO TOMATO VEGE HOT POT MICROWAVE--->海底捞番茄素食自热火锅
HAIDILAO SPICY VEGE HOT MICROWAVE--->海底捞香辣素食微波火锅
HDL TOMOTO VEG SELTHEAT HOTPOT--->海底捞番茄自主素锅
HDL VEGETABLE SELTHEAT HOTPOT--->海底捞香辣自煮素锅
HDL TOMOTO BEEF SELFHEAT HOTPOT--->海底捞番茄牛腩火锅
A-Sha Spicy Hakka Wide Noodle--->阿舍麻辣客家板条
Juliang Organic Black Soybean--->巨量有机黑豆
Juliang Organic Soybean--->巨量有机黄豆
Sau Tao Almond Cookies--->寿桃传统杏仁饼
Jmsolution Goat Milk Mask--->JM山羊奶紧致抗老面膜
Jmsolution Niacin Brightening Mask--->JM胺蔷薇亮肤面膜
Jmsolution Centella Smoothing Mask--->JM积雪草茶树祛痘面膜
Jmsolution Amino Acid Hyal Mask--->JM玻尿酸海藻补水面膜
Fragrance Pepper Crab Fishskin--->清香黑胡椒蟹鱼皮
Fragrance Chilli Crab Fishskin--->清香辣螃蟹咸蛋鱼皮
Zwilling Madura Plus 2Pc--->双立人MADURA锅具组
Leaders Amino Pore-Tight Mask--->丽得姿氨基酸紧致毛孔面膜
Leaders Amino Clearing Mask--->丽得姿氨基酸亮白面膜
Leaders Amino Lifting Mask--->丽得姿氨基酸紧致面膜
Leaders Amino Ac Free Mask--->丽得姿祛痘精华面膜
Juanjuan Alcohol Wipes 50S--->JUANJUAN酒精湿巾50S
Juanjuan Alcohol Wipes--->JUANJUAN酒精湿巾
Shamrock Medical Latex Gloves Large--->SHAMROCK医用胶手套LARGE
Nonmedical Disposable Kid Mask--->非医用一次性儿童口罩
Germifence Surface Disinfectant--->GF特效无味消毒剂
Quaker Brown Grainsnuts Powder--->桂格全天然-黄金坚果
Quaker Mixed Grains Powder--->桂格全天然-十六谷
Chinese Lettuce--->香麦菜(A菜)
ENOKI MUSHROOM--->金针菇
GAI CHOY(LARGE)--->大芥菜
OKRA--->黄秋葵
ELEPHANT PAPAYA--->大象木瓜
RED GLOBE GRAPES--->大红葡萄
LIME--->酸檬
Bosc Pear--->波斯梨
Yukon Potato--->育空马铃薯
Lettuce Stem--->莴苣笋
TW.BOK-CHOY--->台湾白菜
Crown Broccoli--->去头百加利
ORANGE PEPPERS--->橙椒
ORGANIC GALA APPLE--->有機基拿蘋果
Frozen Hokkaido Scallop 10/20--->急冻北海道带子10/20
KOREAN BEEF SHORT RIB--->韓式調味牛仔骨
Crispy Chips-Salted--->香脆巧果(咸)
Frozen Snow Crab Cluster--->特选雪蟹脚
Snow Crab Clusters Gift Boxed--->至尊雪蟹腿礼盒
Mini Japanese Cheese Cake--->迷你日式乳酪蛋糕
Mango Tapioca Cup--->芒果西米露
Milk Plain Loaf--->鲜奶排包
Plain Bread-No Crust--->去皮白方包
Mini Bite Pastry - Pinapple--->迷你一口酥-凤梨
Quaker Quinoa&Nuts Powder--->桂格全天然-藜麦坚果
Quaker Almond&Walnut Powder--->桂格全天然-杏仁核桃
Quaker Walnut & Nuts Powder--->桂格全天然-核桃坚果
Quaker Black Grains&Nuts Powder--->桂格全天然-黑谷坚果
Wong Lo Kat Herbal Tea--->王老吉凉茶
LOTTE BANANA MILKIS--->乐天牛奶香蕉苏打
LAYS DEEP RIDGED COMBO PACK--->乐事大波浪薯片组合包
LOTTE APPLE MILKIS--->乐天苹果牛奶苏打
TUNG-I MATCHA MILK TEA--->统一煎茶奶绿奶茶
Samyang Ramen--->三养牛肉拉面
ITSUKI KUMAMON RAMEN--->五木熊本熊黑蒜拉面
JINJU CHEESE FISH SAUSAGE--->真珠鳕鱼肠-芝士牛奶
VTG JUJUBE GLUTINOUS RICE CAKE--->VTG双枣八宝甄糕
VTG PURPLE POT MILLET RICE CAKE--->VTG紫薯小米甄糕
VTG FIVE NUTS RICE CAKE--->VTG五仁桂花甄糕
QA DIAMOND-CERAMIC WOK 28--->QA钻石瓷不粘炒锅
XPP MATCHA LATTE MILK TEA--->香飘飘抹茶拿铁奶茶
XPP TOFFEE MILK TEA--->香飘飘太妃奶红奶茶
I-Mei Red Bean Pastry W/Yolk--->义美综合蛋黄酥礼盒
Nicesea Multifunctional Glass Kettle--->NICESEA养生壶
Koko Spicy Mushroom Scallop--->KOKO香辣鲍菇扇贝
Koko Spicy Whole Scallop--->KOKO香辣全贝
Koko Bbq Barbecue Clam--->KOKO烧烤味花蛤
Koko Flavored Whole Scallop--->KOKO全贝
Choc Cookie Crust Danish--->巧克力菠萝长奶酥
Wonder 100% Whole Wheat Bread--->100% 全麦方包
Cheese Pudding Danish--->华尔滋布丁奶酪
Bolo Pumpkin Danish W/ Mochi--->麻糬菠萝黄金南瓜
Tray Buns W/Dried Pork--->肉松小餐包
Ch Stone Milled Wheat Bread--->CH麦方包
Haidilao Spicy Spicy Grilled Fish--->海底捞香辣烤鱼套餐
Chicken Udon Soup--->日式鸡肉乌冬
Pork Chop With Black Pepper-L--->黑椒猪扒-大
Salmon Toro Sushi Tray--->特级三文鱼腩寿司
Salmon Avocado Sushi Roll--->三文鱼牛油果卷
Mango Mousse Cake--->芒果慕丝蛋糕
5.2In Green Tea Mousse Cake--->5.2寸绿茶慕丝蛋糕
5.2In Strawberry Mousse Cake--->5.2寸草莓慕丝蛋糕
5.2In Cheese Mousse Cake--->5.2寸芝士慕丝蛋糕
Tong Sheng Shepherds Purse--->同盛荠菜
Long Feng Cuttle Fish Ball--->龙凤花枝扬鱼丸
Jane Jane Japanese Style Frozen Hotpot Combo--->珍珍日式综合火锅料
Sdc Shanghai Style Noodle--->沈大成上海阳春面
Pineapple--->凤梨
Sakura Party Tray--->樱花寿司派对盘
T&T Chinese Pork Sausage Value Pack--->T&T安康猪腊肠家庭装
Kung Fu Duck Spicy Sweet Duck Feet--->精武甜辣鸭掌
Spam Bacon--->SPAM烟肉午餐肉
Lolo Almond Juice 250Mlx6--->露露杏仁露 250毫升X6
Nbr Gloves-L Size--->NBR手套L号
Nbr Gloves-S Size--->NBR手套-S号
Hands-Puri Hand Sanitizer-1 L (Limit 2 Per Order)--->韩国酒精免洗手液-1升
Panasonic 10C Micom Ricecooker--->松下日本制10C电饭煲
Panasonic Srjmy108 Micom Rice Cooker--->松下5杯逻辑电饭煲
Infrared Forehead Noncontact Thermometer--->非接触式额温枪
Children Face Shield--->儿童防护面罩
Non Medical Disposable Kids Mask--->非医用一次性儿童口罩
Tic Tac Coke--->TIC TAC 可口可乐糖
Zwilling Marquina 2Pc Set--->双立人不沾锅套组
Oyatsu Roast Meat Flavour Noodle Snack--->胡同烧肉风味点心面
Non-Medical Adult Face Mask--->非医用一次性防护成人口罩
Vinda Wet Wipe(10Pc)--->维达消毒湿巾独立装
MENGNIU PURE FRUIT BEVERAGE--->蒙牛轻乳玫瑰草莓
MENGNIU PURE FRUIT BEVERAGE--->蒙牛轻乳樱花白桃
Wujiang Pickled Mustard--->乌江鲜脆菜丝
Juliang Wild Black Goji Berries--->巨量野生黑枸杞
Want Want Jelly Drink--->旺旺维多利综合包
Vietcoco Organic Coconut Milk--->VIETCOCO有机椰奶
Qp Mayonnaise Cholesterol-Free--->QP零胆固醇美乃滋
Beidahuang Organic Snap Bean--->北大荒有机油豆角
Dxc Original Cakes--->稻香村冷冻老婆饼原
Dxc Hawthorn Cakes--->稻香村冷冻山楂锅盔
Shao Mei Taro Boba Ice Bar--->小美珍珠芋角冰棒
Chinamaid Cooked Salted Duck Eggs--->荃美熟红心咸蛋
Hot & Sour Soup-Small--->酸辣汤-热(小)
T&T Radish Scone--->T&T萝卜丝烤饼
Love In Thousand Island--->千岛之爱
Broiled Milky Cheese Tart-6Pcs--->烤奶芝士塔-6件(冷)
Broiled Milky Cheese Tart-1Pc--->烤奶芝士塔-1件(冷)
Salted Egg Tart-1Pc--->金沙蛋塔-1件
Osmanthus Ferment Rice Egg White Tart-1Pc--->桂花酒酿蛋白塔1件
Tong Sheng Chinese Yam--->同盛铁棍山药
Shanghai Duck W/Soy Sauce--->上海酱鸭
Soybean W/Preserved Vegetables--->雪菜毛豆
Sweet & Sour Radish--->甜酸萝卜
Seasoned Black Fungus Salad--->凉拌东北黑木耳
Beancurd W/Assorted Vegetables--->五彩腐竹丝
Spicy Pork Stomach--->红油肚丝
Marinated Pig Ear--->卤水猪耳
Spicy Lotus Root--->香辣藕片
Korean Radish Kimchi--->韩式萝卜泡菜
Fresh Spanish Mackerel-L--->新鲜大花鲛鱼
Live Lobster A Grade (Small)--->生猛游水龙虾A级(小)
Loacker Blueberry Yogurt Quadratini--->莱家蓝莓酸奶威化
Nissin Low Sugar Gorotto Granola Soybean--->日清半糖三色大豆麦片
Xpp Original Milk Tea--->香飘飘原味奶茶
Lotte Green Tea Choco Pie--->乐天绿茶巧克力派
House Cream Stew--->屋牌软滑忌廉方块
T&T Roasted White Sesame Seeds--->T&T烤白芝麻
Ashirira Foot Sheet Rose--->中村舒缓疲劳脚贴-玫瑰
FOUE PALACE HOTPOT 36CM--->FOUE PALACE HOTPOT 36CM
Jean Fu Roasted Rolled Squid(160G)--->珍福鱿鱼碳烤片(160G)
Midea 11 Function Micro Cooker--->美的智能多功能电饭煲
Nescafe Original 1+2 Coffee--->雀巢原味1+2咖啡
Nescafe Rich 1+2 Coffee--->雀巢特浓1+2咖啡
Nescafe Smooth Milky 1+2 Coffee--->雀巢奶滑1+2咖啡
SABORINO SB-FACE MASK MIX BERRY--->SBO早安石榴面膜
Pat Chun Sweetened Vinegar Sauce--->八珍甜醋(樽)
Orion Swing Chip Soychicken--->好丽友酱油炸鸡味薯片
Lotte Peach Milkis--->乐天蜜桃牛奶苏打
Xpp Peach & Pink Grapefruit Meco Tea--->香飘飘桃桃红柚果汁茶
Xpp Thai Lime Meco Tea--->香飘飘泰式青柠果汁茶
Xpp Kumquat&Lemon Meco Tea--->香飘飘金桔柠檬蜜茶
Xiao Tian E Hot Pot Seasoning--->小天鹅鸳鸯火锅底料
Nin Jiom Lemongrass Herbal Candy--->念慈庵柠檬草润喉糖
MITSUISEITO WHITE SUGAR--->MITSUISEITO WHITE SUGAR
FOODLABE SEASNING BASE--->FOODLABE SEASNING BASE
Sanquan Sweet Milk-Yellow Bun--->三全甜味奶黄包
Ning Chi Sichuan Chili Hot Pot Soup--->宁记四川麻辣火锅底
Char Siu King Chinese Bbq Pork W/Rice--->叉烧大王叉烧饭
Akita Assorted Sushi Set--->秋田寿司派对盘
Ning Chi Vegetarian Chinese Herbal Soup--->宁记十全十补锅
Mini Cappuccino Tart-8 Pcs--->迷你卡布其诺塔-8件
Rwa Beef Chuck Eye Roll Bls Aa--->全自然雪花牛肩AA
Korean Fried Peanut With Fish--->韩式小鱼花生
Korean Cucumber Cold Dish--->韩式黄瓜
Little Bee Cake--->小蜜蜂蛋糕
Ramen Cake--->拉面造型蛋糕
Custard Puffs-9Pcs--->奶黄泡芙9入装
Tyj Spring Roll Pastry 5In--->第一家春卷皮5IN
SIMPLY ORANGE W/O PULP--->SIMPLY无果粒橙汁
Beef Brisket With White Radish Bento Box--->萝卜牛腩便当
Marinated Chicken Leg Bento Box--->卤水鸡腿便当
Unagi Don--->日式鳗鱼饭
LEMON ICED TEA--->冻柠茶
Banana--->香蕉
Swiss Roll-Cappuccino--->瑞士卷加柏仙奴
Dried Pork & Ham Sandwich--->火腿肉松三明治
Korean Sticky Rice Bun 5Pc--->韩国QQ面包5件
Spinach--->菠菜
FOODLABEL SOYSAUCE SEASNING BASE--->FOODLABEL SOYSAUCE SEASNING BASE
Takumi Japan Made Cast Iron Wok 30Cm--->宅磨匠制中华铁锅30cm
LITTLE SHEEP HOT POT SOUP BASE TOMATO--->LITTLE SHEEP HOT POT SOUP BASE TOMATO
Southern Jujube Black Sesame Paste--->南方红枣味黑芝麻糊
Southern Original Black Sesame Paste--->南方原味黑芝麻糊
Lipton Low Sugar Milk Flv Tea--->立顿减糖原味奶茶
Cx Organic Pure Coconut Water--->CX有机椰子水
Yqsl Tangerine Soda Bubble Water--->元气卡曼橘气泡水
Asha Sesame Oil Knife Cut Noodle--->阿舍香油葱关庙面
Saborino Morning Face Mask White 28S--->SABORINO美白早安面膜
Mixed Flavor Horsebeans--->蝶花牌怪味胡豆
C2 APPLE FLV GREEN TEA--->C2 APPLE FLV GREEN TEA
Yoshikawa Multi Function Pot 18Cm--->吉川雪平锅18CM
Viva Almond & Fish Snack (Can)--->万岁杏仁小鱼(罐装)
Yu Jia Xiang Mild Spicy Roasted Eel--->鱼家香微辣日式烤鳗
Lays Lime Chips--->乐事青柠味薯片大包
Lays Cucumber Chips--->乐事黄瓜薯片大包
T&T FUXIN BAISAH PEANUT--->T&T阜新白沙花生
T&T FUYU RED PEANUT--->T&T扶余红衣花生
Yanmengd Seabuckthorn Fruit Juice--->雁门古道沙棘果汁
Lipton Original Milk Flv Tea--->立顿香浓原味奶茶
Mogu Grape Nata De Coco Juice--->摩酷椰果葡萄汁1L
MOGU MELON NATA DE COCO JUICE--->MOGU MELON NATA DE COCO JUICE
Mogu Strawberry Nata De Coco Juice--->摩酷椰果草莓汁1L
3 Piece Sweet Corn--->三支装甜玉米
Burnbrae Far 18 Pack Prestige Large Eggs--->白鸡蛋-大
UW STICKY RICE W/CHICKEN--->唯一糯米鸡
SUNRISE SWEET SOYA BEVERAGE--->日昇豆浆皇- 甜
SUNRISE TRADITIONAL TOFU 4PCS--->日昇传统鲜豆腐4件装
Watson Fresh Noodle--->华生京都兰州拉面
Iogo Strawberry Nano Drinkable--->IOGO草莓纳米乳酪
Cm Preserved Duck Eggs--->荃美无铅松花皮蛋
Aed Fz. Broiled Eel--->AED急冻蒲烧鳗
Clear Water Fz.Hokkigai--->CW急冻北极贝
Neilson Nls 4L 2% Milk - Bag2--->NEILSON2%鲜奶
NEILSON NLS 4L 2% ORGANIC MILK - BAG--->NS有机2%鲜奶
Neilson Ttt 2L 2% Lactose/F Milk - Ctn--->NS低乳糖2%鲜奶
NEILSON NLS 2L ORGANIC HOMO - CTN--->NS有机全脂鲜奶
T&T FROZEN JAPANESE UDON--->T&T日本乌冬
T&T Pork & Leek Dumplings--->T&T韭菜猪肉水饺
T&T Chicken & Corn Dumplings--->T&T玉米鸡肉水饺V
T&T Veg/Pork/Blk Mushroom Dumpling--->T&T香菇猪肉水饺V
TENTEN PORK & LEEK DUMPLING--->天天韭菜猪肉饺
Grand Maple Chinese Sausage--->枫华特级白油肠
Shikoku Japanese Sanuki Frozen Udon--->四国日本冷冻乌冬
T&T Soft Tofu--->T&T 滑嫩豆腐
T&T Cumin & Onion Pancake--->T&T新疆孜然烧饼
T&T Konjac Yam Noodle Bundles--->T&T 芋丝
Mogu Mango Nata De Coco Juice--->摩酷椰果芒果汁1L
Mogu Mogu Coconut Nata De Coco Juice--->摩酷椰果椰子汁1L
Greenmax No Sugar Flaxseed & Apricot Ke--->马玉山无糖亚麻杏仁粉
Nongshim Gamjatangmyun--->农心韩式背骨土豆汤面
Jutsuxian Caviar Sauce--->菊之鲜顶级鱼子酱
Casa Uji Matcha Milk Flv Tea--->CASA宇治抹茶奶绿
Casa Okinawa Brown Sugar Milk Flv Tea--->CASA冲绳黑糖奶茶
Casa Hakkaidou Milk Flv Tea--->CASA北海道札幌奶茶
UPOC ORIGINAL BROWN SUGAR--->UPOC ORIGINAL BROWN SUGAR
Fun Ye Spicy Sauce--->饭爷麻婆酱汁
Fun Ye Chili Sauce W/Crispy Peanuts--->饭爷落花生香酥脆辣酱
Fishwell Potherb Mustard W Bamboo Shoot--->鱼泉牌雪菜笋丝
Tkn Big Roll Spicy Grill Seaweed Valu Pack--->小老板烤辣紫菜卷家庭包
Chunfa Dried Chrysanthemum--->春发桐乡朵菊
Chunfa Dri Embryo Chrysanthemum--->春发桐乡胎菊
Huai Lian Seaweed Yam Chips--->怀恋鲜香海苔薄片
Xiaolongkan Hot Pot Seasoning--->小龙坎清油火锅料
Marutai Saga Beef Salt Noodles--->丸太佐贺牛盐味拉面
KIKKOMAN GYOZA DIPPING SAUCE--->KIKKOMAN GYOZA DIPPING SAUCE
Qp Sesame Salad Dressing--->优比焙煎胡麻酱
LIN LIN HAINANESE CHICKEN RICE PASTE--->LIN LIN HAINANESE CHICKEN RICE PASTE
Six Fortune Gas Range--->六福瓦斯炉
Mr.Maple Cookie--->枫叶先生饼干
WANGSHOUYI THIRTEEN SPICES--->WANGSHOUYI THIRTEEN SPICES
T&T Fish Shape Fish Cake--->T&T鱼形鱼豆腐
Synear Pork & Leek Dumplings--->思念猪肉韭菜灌汤水饺
T&T Organic Silken Tofu--->T&T有机绢豆腐
T&T Free Run Omega 3 Brown Eggs-L--->T&T OMG3走地黄鸡蛋大
T&T Regular Chn Style Salted Prok Belly--->T&T 安康猪咸肉
Young Coconut--->新鲜椰青
Easy Open Coconut--->易开椰皇
Sun On Dumpling Wrappers--->新安 饺子皮
SIMPLY APPLE JUICE--->SIMPLY鮮榨蘋果汁
T&T MATCHA GREEN TEA ICE CREAM--->T&T 抹茶冰淇淋
Lamb Skewer--->羊肉串
Fz Wild Yellow Croaker--->野生小黄花鱼
Peeled Baby Carrot--->小红萝卜
Frozen Fish Meat Dim Sum--->急冻鱼蓉烧卖 (500g)
CALPICO WATER--->可尔必思水语
HOUSE FOODS PREMIUM FIRM TOFU--->好侍硬豆腐
FRIED NOODLE (E-FU)--->FRIED NOODLE (E-FU)
BURNBRAE FARMS LARGE BROWN EGGS--->黄鸡蛋-大
Happy Meat Pork Sausage--->合利切肉白油肠
HUNG WANG FO EGG WHITE NOODLES--->HUNG WANG FO EGG WHITE NOODLES
Sun On Egg White Noodles--->新安蛋白长春面
Ferma Green Peas--->FERMA青豆
I-Mei Mung Bean Milk Ice Bar--->义美绿豆牛奶冰棒
Lotte Melon Milkis--->乐天蜜瓜牛奶苏打
Kopiko Cappuccino Coffee Candy--->KOPIKO卡普奇诺糖
KOPIKO COFFEE CANDY--->KOPIKO COFFEE CANDY
AMOY OYSTER SUP.SAU.W/SCALLOP--->AMOY OYSTER SUP.SAU.W/SCALLOP
Reno Corned Beef--->RENO牛肉罐
Lotte Strawberry Milkis--->乐天草莓多多苏打
CICI ASSORTED JELLY DRINK--->CICI ASSORTED JELLY DRINK
Chaokoh Quail Eggs In Brine--->秋菊鹌鹑蛋
Trofco Canned Pineapple In L/Syrup--->糖水菠萝-片
Otafuku Okonomi Yaki Set--->多福日式大阪烧套装
LKK PEANUT FLAVORER SAUCE--->LKK PEANUT FLAVORER SAUCE
Kikkoman Tonkatsu Sauce--->万字肉扒酱
HA HA HOT BEAN SAUCE-L--->HA HA HOT BEAN SAUCE-L
Leaperrins Worcestershire Sauce--->李孤霖醋汁-小
VIETNAMESE SPICE FOR PHO--->VIETNAMESE SPICE FOR PHO
Ideal Baking Powder--->理想牌泡打粉
Lays Sour Cream & Onion Chips--->乐事酸奶洋葱薯片
Lays Potato Chips--->乐事原味薯片
Gik Collagen Repair Moist Mask Prp--->GIK血清胶原蛋白面膜
Feng Tai Wei Fried Beancurd Crust--->疯台味火锅豆皮
Kenko Gold Creamy Sesame Dressing--->KENKO金芝麻沙拉酱
Kings Noodle Spicy & Sour Noodle--->金牌干溜酸辣粉
Kings Noodle Spicy Hot Pot Noodle--->金牌干溜重庆火锅粉
MP POPCORN-CORN SOUP FLV.--->MP POPCORN-CORN SOUP FLV.
I-Mei Red Bean Jelly Ice Bar--->义美红豆粉粿冰棒
NORTHERN FOOD DRIED BEAN CURD--->丰业上海五香豆干
Schneiders Cheddar Smoked Sausage--->SH芝士烧烤肠
CALPICO MANGO DRINK--->可尔必思芒果汁
Uw Jumbo Shrimp Wonton--->唯一大虾薄皮云吞
F.A. Pork&Shrimp Rice Noodles--->一路发炒米粉
SEARAY THAI FISH CAKE--->SEARAY THAI FISH CAKE
SUNRISE MEDIUM FIRM TOFU--->日昇红盒豆腐
Shirakiku Lychee Ramune Drink--->白菊荔枝波子汽水
Uw Jumbo Shrimp Chilli Oil Wonton--->唯一大虾红油抄手
FA STEWED BEEF SOUP NDL--->一路发红烧牛肉面
MT FUJI RED BEAN MOCHI ICE CREAM--->富士红豆雪糕糯米粢
FROZEN TOFU--->上海滩阿杜冻豆腐
TROPICANA APPLE JUICE--->TROP苹果汁
SYNEAR CHESTNUT PASTE RICE BALL--->思念紫玉板栗玉汤圆
JOHNSONVILLE CHEDDAR SMOKED SAUSAGE--->JOHN烟芝士香肠
Bdmp Dried Shrimp Ck M--->BDMP虾米CK M
WATSON LONG THIN NOODLES--->华生龙须面
Hime Mango Ice Cream--->姬芒果雪糕
ZHU LAO DA PORK & LEEK DUMPLING--->朱老大汤肉韭菜饺
NANXIANG TURNIP BUN--->南翔萝卜丝包
NANXIANG VEGETABLE MUSHROOM BUN--->南翔香菇菜包
BINGGRAE STRAWBERRY FLAVORED MILK--->冰极草莓牛奶饮料
MAPLE LEAF REGULAR BACON--->枫叶原味烟肉
Samyang Extreme Hot Chicken Flav.Sauce--->三养2倍辣鸡风味辣酱
Samyang Original Hot Chicken Flav.Sauce--->三养火辣鸡肉封为辣酱
Asahi Jurokucha Grain & Botanical Tea--->朝日十六茶
Zx Bamboo Cutted--->竹芯野生火锅笋花
Zx Bamboo--->竹芯野生箭竹水煮笋
Cooker King Non Fume Wok 32Cm--->炊大皇不粘无烟锅32cm
Qa Diamond-Ceramic Wok 32Cm--->QA钻石瓷不粘炒锅32cm
QA DIAMOND-CERAMIC WOK 30--->QA DIAMOND-CERAMIC WOK 30
Knorr Liquid Seasoning Original 1L--->家乐鲜露1L
Lays Spicy Crayfish Flv Chips--->乐事香辣龙虾味薯片
Lays Fried Crab Flv Chips--->乐事金黄炒蟹味薯片
Lays Cucumber Flv Yam Chips--->乐事黄瓜味山药薯片
Fragrance Yolk Tapioca Chips--->清香咸蛋木薯片
Fragrance Yolk Egg Fish Skin--->清香麻辣咸蛋鱼皮
Fragrance Yolk Potato Sticks--->清香咸蛋薯条
Fragrance Yolk Potato Chip--->清香咸蛋薯片
Lfy Hk Style Milk Tea--->兰芳园港式牛乳茶
Xpp Peach Oolong--->香飘飘白桃乌龙奶茶
Glico Passion Fruit Flv Biscuit--->固力果百香果味百醇
Pami Fried Garlic Flavor Tseng Noodles--->曾拌面-金黄香蒜
Da Mu Han Tomato Soup Base--->大牧汗番茄火锅底料
Dsh Dried Lily Bulb--->大山合百合
Joyshare Butane Gas Cartridge--->乐享韩国火锅瓦斯罐
Kai Organic Sushi Seaweed--->海达屋有机寿司紫菜
SANQUAN RED BEAN PASTE GLUTINOUS RICE BL--->三全豆沙汤圆
Neilson Nls 454G Unsalted Butter--->NS 牛油-无盐
RWA PORK SHOULDER BUTT ROLL--->RWA PORK SHOULDER BUTT ROLL
Binggrae Rd Beanfish Ice Sandwich--->冰极红豆三文治
Grand Maple Fz. White Shrimp H/O 50/60--->枫华有头白虾50
Yin On Sour Plum Dirnk--->贤安桂花酸梅汤
MEIXIANG ORIGINAL PRESERVED DUCK EGG--->梅香原味松花皮蛋
Toppits Breaded Tempura Shrimp--->TOPPITS天妇罗炸虾
ASIAN LEGEND DRIED NOODLES W/ SPICY PORK SAUCE--->ASIAN LEGEND DRIED NOODLES W/ SPICY PORK SAUCE
Quinoa Wheat Bread--->藜麦方包
MANNARICH FOOD FISH PASTE WTH BLACK MOSS--->满盛发财冻鲮鱼浆
ASIAN LEGEND RICE W CK THREE CUP SAUCE--->味香村三杯鸡饭
NISSIN SHRIMP DUMPLING--->日清鲜虾饺
Organic Ez Peel Bt Shrimp 26/30--->有机开背虎虾26/30
IOGO NANO DRINKABLE- BANANA--->IOGO香蕉优格饮
SAM HU GLUTEN--->珊瑚 面根
Synear Rabbit Shaped Bun--->思念玉兔奶黄包
WZW MUSHROOM PORK BALL--->丸中王潮式香菇贡丸
CHONGGA FRESH TUBULAR RICE CAKE--->宗家新鲜年糕条
CHONGGA FRESH SLICED RICE CAKE--->宗家新鲜年糕片
Organic Mixed Baby Greens--->有机混合叶菜
Boston Spicy Korean Bbq Pork Belly--->BS 韩式烧烤五花腩
3 Fish Frozen Frog Leg 6/8--->三鱼牌急冻田鸡腿
Seafood Platter + Sushi Combo--->豪华海鲜拼盘套餐
Nong Shim Beef Big Bowl Sarigomtang--->农心牛骨汤碗面
Nong Shim Seafood Big Bowl Neoguri--->农心海鲜乌冬碗面
Nong Shim Chajang Big Bowl Chapagetti--->农心炸酱风味碗面
Want Want Black Pepper Golden Rice Cracker--->旺旺胡椒小小酥经济包
LEE KUM KEE CHOY SUN OYSTER SAUCE--->李锦记财神蠔油
BAIJIA SPICY FRIED DISHES SEASONING--->白家麻辣香锅调料
PALDO SPICY BIBIMMEN COLD NOODLE 4PK--->八道辣味冷面4包
WANGJIADU SPICY HOT POT SEASONING--->王家渡麻辣香锅料
NISSIN CHICKEN CUP NOODLE--->合味道鸡肉杯面
LGM CHILI PASTE CHILI--->老干妈风味糟辣椒
HANYUAN PEPPER--->汉源花椒
NONG SHIM KINCHI RAMYUN MULTI--->农心泡菜面四包装
SOO SPICY GRILLED BEEF JERKY--->狮牌辣牛肉乾
PALDO NAMJA RAMEN--->八道男子面
SEKKA SUSHI RICE--->雪花寿司米
SHIQUANSHIMEI PRESERVED OSMANTHUS FLOWER--->食全食美糖桂花
NONG SHIM SHIN RAMYUN- SHRIMP--->农心鲜虾拉面5 包装
TUNG-I INSTANT NOODLE- PORK--->统一五包装肉燥面
PRIMA TASTE LAKSA--->百胜厨叻沙
HEINZ EZ SQUEEZE KETCHUP--->亨士易挤茄汁
WJS RED VINEGAR--->万家香大红浙醋
WZH LEEKS FLOWERS SAUCE--->王致和韭花酱
HOUSE VERMONT CURRY-MEDIUM--->屋牌日本咖哩中辣
HOUSE VERMONT CURRY-MILD--->屋牌日本咖哩甘口
Quail--->鹌鹑
Top Chef Sole Fillets - Value Pack--->顶厨龙利鱼柳-经济包
Fz Cooked Shrimp Meat--->急冻去肠熟虾仁
Toppits Smoked Coho Salmon--->急冻烟COHO三文鱼
Unique Wonto Canton Shrimp Dumpling--->唯一广东鲜虾水饺
Ferma Sweet Corn--->FERMA甜玉米
BANGKOK BEEF TENDON BALLS--->曼谷潮州牛筋丸
Meng Niu Milk Pudding Ice Bar--->蒙牛布丁雪条
BINGGRAE LYCHEE PEACH MILK DRINK--->冰极荔枝桃牛奶饮料
Np Mung Bean Ice Bar--->东北大板绿豆冰棍
Ytjh Frozen Cooked Spicy Crayfish--->一桶江湖香辣小龍蝦
NEW ZEALAND SPRING LAMB POTSTICKERS--->新西兰全自然羊肉饺
TROPICANA NO PULP ORIGNAL--->TROPICANA NO PULP ORIGNAL
EVER RICH SEAFOOD MIX--->ER急冻海鲜包
WZW EEL FISH BALL--->WZW EEL FISH BALL
SIWIN SWEET LONGANISA PHILIPINO SAUSAGE--->SIWIN SWEET LONGANISA PHILIPINO SAUSAGE
SUN ON ORGANIC WAXY CORN WHITE--->SUN ON ORGANIC WAXY CORN WHITE
STEAMED BUN W/BROWN SUGAR--->舒汇手撕红糖馒头
I-Mei Brown Sugar Pearl Ice Bar--->义美黑糖珍奶雪糕
Bbq Eel Sushi--->鳗鱼寿司
Burnbrae Far Large White Eggs--->白鸡蛋-大
KIMLAN GLUTEN / MUSHROOM--->金兰香菇面筋
DINGS FOOD FIVE SPICE POWDER--->真好家五香粉
HF CHILI GARLIC SAUCE--->汇丰蒜蓉辣椒酱
HEINZ KETCHUP--->亨氏蕃茄酱
LKK SATAY SAUCE--->李锦记沙爹酱
LKK SA CHA SAUCE--->李锦记沙茶酱
Oxhead Fragrant Rice--->牛头牌香米
Mizkan Kimchi Nabe Soup Base--->味滋康泡菜火锅高汤底
JEAN FU ROASTED SHREDDED SQUID(160G)--->珍福魷魚碳烤絲(160G)
T&T ORGANIC COCONUT WATER--->T&T有機椰子水
NISSIN SHOYU TONKOTSU INST NOODLE--->出前一丁東京豬骨5包
NISSIN MISO TONKOTSU 5P--->出前一丁味噌豬骨5包
RU SHUI CRISPY PEANUTS--->如水魚皮花生
NISSIN TONKOTSU INSTANT NOODLE (5 PACKET--->出前一丁猪骨5包
NISSIN BEEF INSTANT NOODLE (5 PACKETS)--->出前一丁牛肉5包
T&T Thai Jasmine Rice 40Lb--->T&T泰国茉莉香米40LB
Ac Non Gmo Soybean Roll--->亚洲首选非基转铃铃卷
Kikkoman Pon Zu Soy Sauce--->万字橘子豉油
EAGEL COIN FRIED DACE WITH SALTED BEANS--->鹰金钱豆豉鲮鱼
Heiwa Calrose Rice--->平和寿司米
Jin Ling Zhi Thai Fragrant Rice--->金灵芝泰国香米
Lotte Milkis Soft Drink 250Mlx6--->乐天牛奶苏打 250毫升X6
ORGANIC ADZUKI BEAN 908G--->日式红豆908G
Snp Gold Collagen Ampoule Mask--->SNP 黄金胶原面膜
Matcha Red Bean Cake Square--->抹茶红豆蛋糕砖
Seoul Chocolate Bun--->首尔可可包
Makimono Combination--->卷物结合寿司
Marinated Duck Wings--->卤味鸭翼
Stewed Beef Brisket W/Daikon-S--->萝卜牛腩-小
Diced Chicken W/Lemon Sauce-S--->柠汁芝麻鸡-小
Truedan Brown Sugar Boba Milktea Drumsticks--->珍煮丹黑糖珍奶甜筒
Napoleon Green Tea Cake Roll--->拿破仑绿茶蛋糕卷
60 Whole Wheat Bread--->60麦方包
Pumpkin Seed Crisps--->南瓜子香片
Coconut Butterfly Bun--->椰丝蝴蝶包
Bright Dairy White Snow Ice Cube--->光明牌白雪中砖
Bright Dairy White Bear Ice Bar Mix--->光明熊小白冰淇淋
Bright Momchilovtsi Icebar Rose--->光明酸奶冰淇淋玫瑰
Cabbage Pork Bun-4 Pcs (Cold)--->高丽菜肉包-4件 (冷)
Vegetable Steamed Bun-4Pcs (Cold)--->素菜蒸包4件(冷)
Yafang Salted Egg Yolk Flavour Ice Bar--->雅方蛋蛋冰-咸蛋黄味
PORK COLLAR BUTT--->新鲜梅头瘦肉
PORK LOIN-BONELESS CENTRE-CUT--->豬肉眼
RWA PORK BNLS HAM--->全自然猪腿瘦肉
RWA PORK BUTT (BONELESS)--->全自然叉烧肉去骨
BEEF FLANK STEAK CUT FROM AA--->法蘭西炒牛肉
BEEF SHANK DIGITAL MUSCLE--->新鮮金錢腱
Queen Art Marble Coating Nonstick Wok 28Cm--->韩国QUEEN ART石纹不粘炒锅28CM
NONGSHIM MUSHROOM NOODLE--->农心香菇即食面
A+ JAPANESE STYLE UDON NOODLE--->A+日式乌冬面
SPAM LITE LUNCHEON MEAT--->SPAM低脂午餐肉
Quaker Large Flake--->桂格传统麦片
T&T Sweetened Condensed Milk--->T&T炼奶
T&T Cheese Cracker--->T&T 芝士饼乾
SENSODYNE BRILLIANT WHITENING TOOTHPASTE--->舒酸定灿烂美白牙膏
Mandom Barrier Repair Hyaluronic Smooth Mask--->曼丹贝儿玻尿酸面膜
Mandom Fusain Facial Wash--->曼丹美乐活性碳洗面乳
DMDQ RICE VERMICELLI--->东明大桥新竹米粉
Dmdq Hawthorn Flakes--->东明大桥山楂饼
BEAN FAMILY DRIED BEANCURD STICK--->豆之一家圆枝腐竹
SEMPIO HOT PEPPER PASTE--->泉字红辣椒酱
Terra Original Vegetable Chips--->TERRA原味薯片
WANJASHAN ORGANIC LESS SODIUM SOY SAUCE--->万家香有机薄盐酱油
YUNG QUN ZHANGHUA NATURAL RAISIN--->优群彰化巨蜂葡萄
LION COMPACT HEAD SYSTEMA TOOTHBRUSH--->狮王小号适齿美牙刷
T&T Glutinous Rice--->T&T特级糯米
Lotte Pepero Almond Chocolate Biscuit Stick--->乐天杏仁脆棒
Lee Kum Kee Less Sodium Soy Sauce--->李锦记减盐酱油
POCARI SWEAT ION SUPPLY DRINK--->宝矿力运动饮料
Que Hua Fried Dace With Black Bean--->雀花牌豆豉鲮鱼
Fuku Superior Soup Rice Noodle--->福字上汤米粉
LAMB SHOULDER (BONELESS)--->羊肩肉(無骨)
CORNISH CHICKEN  400G--->童子雞
PORK SHOULDER BUTT SLICE--->顶级叉烧肉卷
PORK HAM BONE--->猪筒骨
BEEF CHUCK FLAT SLICE--->頂級霜降雪花肥牛
ANGUS BEEF RIB EYE STEAK--->頂級安格斯肉眼牛扒
ANGUS BEEF EYE OF ROUND STEAK--->安格斯牛腿肉眼扒
ANGUS BEEF CHUCK ROLL--->安格斯牛肩肉
KOREA-STYLE BEEF SHORT RIB SLICE (B/I)--->韓式牛仔骨片
RWA PORK SIDE RIB-CUT--->全自然精切排骨条
RWA DUCK LEG--->全自然鴨腿
FZ. TOOTHFISH STEAK--->急冻银鳕鱼扒
BEET--->甜菜
NAPA(SHORT)--->绍菜
RED ONION--->紅洋蔥
DRAGON FRUIT--->火龍果
ROMA TOMATOES--->罗马蕃茄
YAM--->蕃薯
BUTTERNUT SQUASH--->白脫瓜
Guava--->芭乐
Chinese Hon Pear--->中国香梨(新疆)
Asparagus--->芦笋
HONEY CRISP APPLE--->香檳蘋果
OYSTER MEAT - 32OZ (Fresh)--->罐装鲜蚝- 32OZ
Fuku Superior Soup Noodle--->福字上汤伊面
JINMAILANG LONGXU THIN NOODLE--->今麦郎手打龙须面
Bourbon Fettuccine Grape Gummy--->波本提子软糖
Mandom Barrier Colagen Mask--->曼丹贝儿胶原蛋白面膜
Juliang Organic Mung Bean--->巨量有机绿豆
BLUE DIAMOND WHOLE NATURE SNACKING ALMOND--->蓝钻石无盐杏仁
WEDDERSPOON RAW MANUKA HONEY KFACTOR12--->麦卢卡蜂蜜活跃12
T&T Crispy Shredded Dried Pork Floss--->T&T猪肉酥
WINGS YET CA MEIN--->永兴隆一家面
Bifesta Moist Cleansing Lotion--->BIFESTA保湿型即净卸妆水
T&T Unsalted Cashews--->T&T 原味腰果
Hetianyu Six Stars Red Dates--->和田玉六星级红枣
Vita Less Sugar Chrysanthemum Tea--->维他少糖菊花茶
Panasonic Fuzzylogic Rice Cooker 5 Cups--->松下5杯逻辑电饭煲
COPPERDRUM DRY ROASTED SALTED CASHEWS--->铜鼓盐味非油炸腰果
Qijiwei Almond Cookie--->奇之味粒粒杏仁饼
T&T SUSHI NORI--->T&T 寿司海苔
Dmdq Preserved Tangerine Peel Flavour Plum--->东明大桥陈皮梅
BIFESTA MOIST CLEANSING SHEET--->BIFESTA保湿即净卸妆棉
Yejimiin Mild Herb Silk Sanitary Pad 28Cm--->YEJIMIIN草本丝面卫生棉28CM
YEJIMIIN MILD HERB SILK SANITARY PAD 23CM--->YEJIMIIN草本丝面卫生棉23CM
Yejimiin Rich Herb Cotton Sanitary Pad 28Cm--->YEJIMIIN草本棉面卫生棉28CM
TOPPITS JAMBO BLACK TIGER SHRIMP HO 8/12--->珍寶開背老虎蝦8/12
Crispy Chips-Sweet--->香脆巧果(甜)
Plain Loaf--->排包
Ham & Egg Sandwich--->火腿蛋三明治
Crispy Top Danish Short--->原味丹麦菠萝
Sesame Balls--->笑口枣
Wild Sweet Salad Shrimp--->野生北极熟甜虾
Korean Shine Muscat--->韩国晴王葡萄
Chicken Yaki Udon--->烤鸡炒乌冬
Minced Beef Yaki Udon--->照烧碎牛肉炒乌冬
Mushrooms & Beancurd Roll--->千层腐皮卷-2件
Fish Fillet & Pork Dumpling (Raw)--->鱼肉三鲜饺(生)
Flavored Bamboo--->美味脆笋
Ice Milk Tea--->冻奶茶
Yaa Fang Assam Boba Milk Tea Ice Bar--->雅方阿萨姆珍奶雪糕
Tiger Sugar Boba Milk Ice Cream Bar--->老虎堂黑糖波霸雪糕
Lotus Root& Seed W/Pork Bones--->双莲红豆猪展汤
Fish Fillet In Spicy Sauce-Large--->水煮鱼片-大盒
Vege Assorted Gluten-Two Items--->素双拼
Yhgd Stove Roast Duck Egg--->盐河土炉烤鸭蛋
5.2In Yogurt Mousse Cake With Lime&Blueberry Jelly--->青柠乳酪蓝莓优格糕
Honey Pomelo--->中国红肉柚子
Seafood Mix (Frozen)--->蜜柚
T&T Premium Dark Soy Sauce--->急冻海鲜(经济包)
T&T LOMEIN NOODLE--->T&T 特级老抽
Hadalabo Gokujyun Hyaluronic Light Lotion--->T&T 捞面
HADALABO SHIROJYUN WHITENING GEL--->肌研极润玻尿酸清爽化妆水
Nature Republic Soothing Moisture Aloe Vera Gel--->肌研白润美白凝露
T&T CUT YOUNG BABY CORN--->NATURE REPUBLIC芦荟保湿水凝胶
GREAT MOUNTAIN GEINSENG INSTANT COFFEE--->T&T玉米笋(切)
GLICO POCKY GREEN TEA BISCUIT STICK--->大山行花旗参咖啡
Apiario Silvestre Green Propolis--->固力果绿茶百奇
AGF BLENDY STICK MILK TEA--->野花牌巴西绿蜂胶
AGF BLENDY STICK ESPRESSO--->AGF 即溶奶茶
KINGO BLACK RICE--->AGF特浓即溶咖啡
WEI SUN ROCK SUGAR--->金谷黑香米
WEI SUN BLACK SUGAR--->维生超级冰糖
KUMANO HORSE OIL CONDIDIONER--->维生台湾味黑糖
Haday Premium Soy Sauce--->熊野马油护发乳
Choillse Ruoqiang Red Dates--->海天味极鲜酱油
Heyu Ruoqiang Red Dates--->长思若羌红枣
Heyu Black Fungus--->禾煜若羌红枣
VINAMILK SWEETENED CONDENSED CREAMER--->禾煜黑木耳
Phidelia Dried Apricot--->长寿炼奶
Chuanqi Delicious Hotpot Seasoning--->PHIDELIA杏脯
HSUFUCHI PINEAPPLE PASTRY--->川崎美味火锅调料
Loacker Qand Tiramisu Wafer--->徐福记凤梨酥
Tong Sheng Whole Okra--->莱家义大利威化
Long Feng Tempura-Slice--->同盛黄秋葵
Ygf Ice Rosa Roxburghii Drink--->龙凤台式甜不辣-片
Crown Imitation Snow Crab Leg--->羿宫坊冷冻刺梨汁
Sanko Assorted Sushi Tray--->皇冠仿雪蟹柳
Cream Puff Swiss Roll--->三幸寿司派对盘
6In Blueberry Swirl Cheesecake--->甜心泡芙瑞士卷
Salted Free-Range Chicken--->6寸蓝莓芝士蛋糕
Shao Mei Boba Pudding Ice Bar--->贵妃走地鸡- 半只
Tong Sheng Slender Bamboo Shoots--->小美珍珠布丁冰棒
Kings Cook Spaghetti With Clams In Pesto--->同盛小竹笋
Spicy Crayfish (H)--->金品奶香青酱蛤蜊面
T&T Shrimp Dumplings--->香辣小龙虾(热)
T&T Layered Chives Pie--->T&T虾饺
Salmon Crazy Sushi--->T&T韭菜千层拉饼
Assorted Sushi Set--->三文鱼寿司组合
Ambrosia Apple-Bag--->袋装安培士苹果
Assorted Pomelo(4 Pcs)--->四色彩柚
Brown Mushroom--->棕色蘑菇
Portuguese Tart W/ Pearl-6Pcs--->黑糖珍珠塔-6件
Red Bean Mochi Egg Tart-1Pc--->红豆拔丝麻糬蛋塔-1件
Sweet Milk Egg White Tart-6 Pcs--->甜奶蛋白塔(冷)-6件
Tong Sheng Winter Bamboo Shoots--->同盛冬笋尖
Achino Match Brn Sugar Boba Bar--->阿奇侬抹茶珍珠雪糕
A+ ORINTAL STYLE NOODLE--->A+传统面条
Stassen Pure Jasmine Green Tea--->司迪生茉莉绿茶
SAU TAO SPINACH NOODLES--->寿桃特级菠菜面
Yanaga Iriko Niboshi--->日本小银鱼乾
COCON MAGO PUDDING WITH NATA DECOCO--->可康芒果椰果布丁
MAGGI SEASONING SAUCE (YELLOW)--->美极黄盖鲜酱油
CHUANGS DONGDING OOLONG TEA--->庄记冻顶乌龙茶
Vita Honey Chrysantheum Tea--->维他蜜糖菊花茶
Vita Sugar Cane Juice Drink--->维他甘蔗汁
GINA MANGO NECTAR--->真雅芒果汁
Shiseido Super Mild Fresh Green Shampoo--->资生堂超柔绿野芳香洗发水
LIPTON YELLOW LABEL TEA BAG--->立顿黄标茶包
FENGMEI INSTANT HONEY GINGER DRINK--->丰美中国蜂蜜姜晶
Old Town Original White Coffee--->旧街场三合一白咖啡
LONGEVITY CONDENSED MILK--->寿星公炼奶
Dan-D-Pak Quick Oats--->丹蒂快熟燕麦片
SINA ORIGINAL GINGER CANDY--->印尼新亚姜糖
FAIR BRAND JASMINE RICE--->阿姐靓米
YUMMY HOUSE PREMIUM SOY SAUCE--->美味栈古法头抽
SUN KUNG 2-LAYER VACUUM MEAL BOX--->三光真空保温饭盒
KINGO ROCK SUGAR--->金谷牌黄冰糖
YUYUAN PRESERVED CHINESE CABBAGE--->榆园酸白菜- 颗
KINGO DRIED BEANCURD STICK--->金谷牌圆枝竹
Glutinous Rice/Preserved Meat-Hot--->腊味糯米饭(热)
Stewed Pork Feet-Cold--->南乳猪手(冷)
Seasoned Seaweed--->凉拌海带丝
Spicy Beef Shank W/Parsley--->香菜牛腱
Spicy Beef Tendon--->麻辣牛筋
Frozen Yellow Croaker-China 400/500--->中国黄花鱼400/500
Foong Chicken Tomato Spaghetti--->丰师傅鲜茄鸡肉意粉
Beef Chuck Flap Tail--->顶级牛坑腩
Korean Seasoned Jalapeno--->韩式辣椒片
Korean-Style Seasoned Burdock--->韩式牛蒡
Bakery Fantastic Combo--->魅力组合
Avocado--->牛油果
Raisin Bread--->提子方包
Swiss Roll--->原味瑞士卷
Banana Cake--->香蕉蛋糕
Marinated Lamb Skewer--->腌制羊肉串
KIRIN DRINK GOGONO KOCHA MILK--->麒麟午後红茶奶茶
SHIRAKIKU ORGANIC FERMENTED NATTO--->有机栽培纳豆
RED BEAN PASTE SHIRAKIKU--->白菊印红豆泥
SPICY BEANCURD--->上雅五香豆乾
Hung Wang Fo Wonton Wrappers--->鸿运 鲜薄云吞皮
Sun On Dumpling Wrappers--->新安 上海大白皮
YOPLAIT STRAW-BANANA/RASP YOGURT DRINK--->YOP综合水果优酪乳
CF SPICED SOYA BEAN--->丰业五香豆乾
KINGO SNOW FUNGUS--->金谷牌雪耳
Gallo Extra Virgin Olive Oil--->GALLO 特纯橄榄油
Marukin Thick Cut Baum Kuchen Cake--->丸金北海道厚切蛋糕
FANSAOGUANG PRESERVED MUSHROOM--->饭扫光即食野香菌
TONG YENG CHILI ROAST EEL--->同荣辣味红烧鳗
CANAAN ALOE CITRON DRINK--->加南芦荟柚子茶
HONG FAN TIAN CHILI PASTE--->红翻天纯鲜剁辣椒
LS HOT POT SOUP BASE-HOT--->小肥羊辣火锅汤料
Sau Tao Pickled Vegetable Rice Vermicelli--->寿桃小桥米线雪菜味
Vita Lemon Tea--->维他柠檬茶瓶装
GREENMAX BLACK BEAN & WHOLE GRAINS CREAL--->马玉山全谷滋养餐
Lee Kum Kee Soy Sauce--->李锦记鲜味生抽
MASTERKON JASMINE TEA--->康师傅茉莉清茶
YMY DRIED VEGETABLE-SWEET--->金牌惠州甜梅菜王
HUNG FOOK TONG PEAR TEA DRINK--->鸿福堂雪梨茶
CYC EGG CRISPY SACHIMA--->精益珍蛋酥沙琪玛
CYC SESAME CRISPY SACHIMA--->精益珍芝麻沙琪玛
Gatsby Moving Rubber Cool Wet Hair Wax--->杰士派水感酷型发蜡
Marukyu Matcha Dorayaki--->丸京绿茶铜锣烧
UFC SWEET FILIPINO SPAGHETTI SAUCE--->UFC菲式甜意粉酱
GREENMAX YAM & BLACK SESAME CEREAL--->马玉山药黑芝麻糊
SMOKED PACIFIC SALMON BOX--->太平洋三文礼盒
G7 3 IN 1 INSTANT COFFEE--->G7三合一咖啡
LOCK&LOCKGLASS CONTAINERS RECTANGULAR 1000ML--->L&L玻璃长盒1000ML
BURNBRAE FARMS WHITE EGGS-L--->BF大白鸡蛋
Yin On Soya Drink--->贤安甜豆浆
Hohoho Beef Tendon Ball--->好好好牛筋丸
Hohoho Black Pepper Beef Ball--->好好好黑椒牛柳丸
I-MEI FROZEN WAFFLE--->义美蛋饼皮
OCEAN FOOD TEMPURA COMBO - A--->日式炸鱼饼炸蟹丸
Ocean Food Tempura Combo - B--->日式炸鱼条炸鱼丸
CASTELLA HONEY CAKE - ORIGINAL--->长崎蜂蜜蛋糕
Ho Ho Ho Great Choice Combo-A--->好好好什锦精选-A
ITOEN KIM NO OOLONG TEA--->伊藤园乌龙茶
An Ching Red Bean Rice Ball--->安井宁波豆沙汤圆
Uw Jumbo Shrimp Capelin Shao Mai--->唯一大虾鱼子烧卖
Myojo Nama Yakisoba- Shio--->明星酱烧炒面
YIN ON CHRYSANTHEMUMS HONEY DRINK--->贤安杭菊蜜
Wahaha Apple Nutri-Express--->娃哈哈苹果牛奶
Searay Pfp Imitation Tofu Fish--->海威豆腐鱼
BURNBRAE OMEGA3 EGG WHITE L--->奥米加大白蛋18S
Grand Maple Salted Seaweed Slice--->枫华盐渍海带丝
SUNRISE BLUE PACK TOFU--->日昇蓝盒豆腐
SUNRISE ALMOND DESSERT--->日昇杏仁豆腐花
FORTUNE AVENUE BEEF BOWL--->一路发松阪牛肉饭
DOLL SEAFOOD DUMPLING (SHAO MAI)--->公仔烧卖
DOLL SHRIMP & FISH DUMPLING (HARGOW)--->公仔虾饺
TROPICANA PURE ORANGE JUICE GOVESTAND--->TROP纯橙汁鲜果粒
HANKOW STYLE DRY NOODLE--->大汉口热乾面
GEN-JI-MAI BROWN RICE--->金谷玄滋糙米
SHJ SPICY GREEN PEAS--->盛香珍香辣青豆
Tung-I Ice Ice Tea--->统一冰红茶
TASCO YOUNG COCONUT JUICE WITH PULP--->达斯克粒粒椰子汁
GOLDEN BUFFALO BROWN SUGAR--->金牛宝岛黑糖
SEMPIO BULGOGI MARINADE--->泉字韩国烤肉酱
Chiao Kuo Natural Coconut Milk Drink--->巧口天然椰子汁
T&T FOLDABLE SHOPPING BAG--->T&T摺叠环保袋
T&T 10 Multigrain Rice--->T&T十谷米
SLS RICE PUDDING--->爽露爽佬米酒醪糟
BANGKOK MEAT BALLS HOT CHILI OIL--->鸡标潮州辣椒油
EDISON CHOPSTICK PORORO--->儿童筷子企鹅
EXCEL PEPPERMINT--->益达薄荷糖
GREENMAX NATURAL SUGAR FREE ALMOND POWDER--->马玉山杏仁粉无糖
LEE KUM KEE BROWN BRAISING SAUCE--->李锦记红烧汁
Vita Tsing Sum Zhan Winter Honey& Lime Drink--->清心栈冬蜜青柠
Prince Of Peace Ginger Chewy Candy--->太子牌姜糖
KAO LIESE BUBBLE HAIR COLOR MILK TEA BROWN--->花王泡沫染发奶茶棕
GREAT MOUNTAIN MEDIUM SHORT GINSENG--->大山行中枝花旗蔘
CSC LOVERS OF HOKKAIDO BISCUIT--->北海道恋人巧克饼
Royal Family Pineapple Yolk Cake--->皇族凤凰酥礼盒
Fa Teriyaki Chicken Rice--->一路发日式鸡肉饭
Bangkok Pork Balls--->曼谷新竹贡丸
BANGKOK SEASONED MUSHROOM BALLS--->曼谷香菇貢丸
UNCLE BILL DRIED SHRIMP--->UB粉红虾皮
Mt Fuji Green Tea Mochi Ice Cream--->抹茶雪糕糯米粢
House Spaghetti Shirataki Noodles--->屋牌豆腐意面
HAN-KA CUT KIMCHI- L--->韩家韩国泡菜- 中
ZHU LAO DA PORK & CABBAGE DUMPLING--->朱老大汤肉白菜饺
Nan Xiang Gultinous Rice Dumpling--->南翔糯米烧卖
Alice Mango Mt Fuji Mochi Ice Cream--->ALICE芒果雪糕糯米兹
SHENDAN COOKED SALTED DUCK EGG--->神丹金黄熟咸鸭蛋
Cm Salted Duck Eggs--->荃美特大红心咸蛋
SANQUAN FRESH MILK FLAV STEAMED BUN--->三全鲜奶馒头
MR FISH BALL--->满盛鱼蛋
OTASTY VEGETABLE CHICKEN POTSTICKERS--->全美鸡肉锅贴(大)
Hua Yang Headless White Shrimp 26/30--->华洋去头白虾26/30
SUNTORY BIKKLE 500--->三多利乳酸饮料
BURNBRAE FARMS NATUREGG 18 PK OMEGA 3 BR--->BF奥米加大黄蛋
Oasis Premium Orange Juice--->OASIS橙汁-无果肉
Owl Stir Fried Kimchi W/ Rice--->猫头鹰炒辣泡菜饭
Neilson Nls 454G Salted Butter--->NS牛油-含盐
BUONO MANGO NON DAIRY FZ DESSERT MOCHI--->芒果椰奶雪麻糬
Binggrae Melona Ice Waffle-Choco Syrup--->冰极巧克力三文治
1ST CHOICE MAT KIMCHI MED--->第一选韩国泡菜中
Want Want Vegetable Flavour Potato Twists--->旺旺蔬菜味浪味仙
XIANGXUE STEAMED BUN FLOUR--->香雪馒头包子小麦粉
PACIFIC INTERNATIONAL 2S DRIED SQUID--->太平洋2S九龙吊片
PACIFIC INTERNATIONAL DRIED SCALLOP--->太平洋青岛元贝
PACIFIC INTERNATIONAL DRIED SQUID--->太平洋阿根廷鱿鱼
Soo Fruit Flavoured Beef Jerky--->狮牌果汁牛肉乾
Soo Spicy Grilled Pork Jerky--->狮牌辣味烧烤猪肉乾
KIM SUGAR FREE GENUINE BIRDS NEST DRINK--->金羽燕无糖燕窝饮
Mediheal N.M.F Aquaring Ampoule Mask--->可莱丝强效保湿针剂膜
Zojirushi Ve Thermal Pot 4L--->象印超保温电水壶4L
Unique Wild Dry Sea Cucumber--->唯一带筋野生海参
Health Style Sugar Free Black Bean Powder--->健康时代无糖黑豆粉
LEADERS AMINO MOISTURE MASK--->丽得姿氨基酸补水面膜
Soo Five Spices Beef Jerky--->狮牌五香牛肉乾
SOO SATAY BEEF JERKY--->狮牌沙爹牛肉乾
SENDAMIZUO HOKKAIDO RICE--->千田瑞穗北海道米
Dariya Salon De Pro Hair Dye #2 Brighter Brown--->达雅SALON DE PRO染发#2淡棕
DARIYA SALON DE PRO HAIR DYE #5 NATURAL BROWN--->达雅SALON DE PRO染发#5自然棕
DARIYA SALON DE PRO HAIR DYE #6 DARK BROWN--->达雅SALON DE PRO染发#6深棕
Snp Diamond Brightening Mask--->SNP 钻石亮白面膜
SANA NAMERAKA ISOFLAVONE SOY MILK FACIAL WASH--->莎拿豆乳美肌洗面乳
EMF CAN OPENER--->EMF罐头刀
INOSUKE DRIED JAPANESE SOMEN--->伊之助日式挂面
WEIDUOBAO DRIED ZHENMO MUSHROOM--->维多宝精选榛磨
LKF SALTED EGG YOLK CUSTARD RICE BALL--->利口福流沙汤圆
Samurai Menshogun Udon--->面将军日本乌冬
CYNTHIA VEGETABLE&PORK BUN--->嘉佳菜肉大包
Long Feng Frozen Mix Dumpling--->龙凤四大天王火锅饺
LAO BEI JING HONEY ORGANIC YOGURT DRINK--->老北京蜂蜜有机酪乳
Asian Legend Rice With Ribs Black Bean Sauce--->味香村豉汁排骨饭
Food For You The Kimchi--->FOOD 4 U泡菜
Synear Fried Stick--->思念放心油条
T&T Chn Style Salted Pork Belly W/Pepper--->T&T 安康猪咸肉辣
Marukome Less Sodium Organic Cup Miso--->丸米低钠有机味噌
Chinamaid Fried Stick Bean Curd--->荃美鲜炸腐竹
WZW BEEF TENDON BALL--->丸中王潮式牛筋丸
Fz Cooked White Shrimp H/O 14/18--->泰国有头熟大虾
Clear Water White Cockle Clams--->北极白玉贝
Cello Brown Mushroom--->盒装棕色蘑菇
Sweet Kale Salad--->甘蓝沙拉
Passion Fruit--->热情果
Teriyaki Salmon Don--->烧汁三文鱼饭
Cold Soy Drink--->冰豆浆
Chinese Golden Pear--->中国水晶梨
Bok Choy Sprout--->白菜苗
Assorted Chinese Sweet Pastry--->什锦四式酥
Amber Walnuts (L)--->琥珀核桃
Mini Coconut Bun--->迷你鸡尾包 6件
Zojirushi Micro-Computer Thermal Pot Lfc30wa 3L--->象印微电脑水壶3L
Zojirushi Micro-Computerthermal Pot Lfc40wa 4L--->象印微电脑水壶4L
T&T Organic Soy Bean--->T&T 有机黄豆
T&T BEECH WOOD COOKING SPOON--->T&T 榉木煮食大勺
T&T PATTERNED BAMBOO CHOPSTICKS 4 PAIRS--->T&T 四君子竹筷4对
ROOSTER DRIED FLOWER MUSHROOM--->雄鸡牌冬菇
T&T Medium Hot Xo Sauce--->T&T中辣XO酱
SOFY HERBAL COTTON SANITARY PAD 29CM--->苏菲贵爱娘中草药纯棉卫生棉29CM
LIUQUAN LIUZHOU SPICY RICE NOODLE--->柳全螺蛳粉
DASHANHE DRIED LILY FLOWER--->大山合黄花菜
Kadoya Sesame Oil--->八角麻油
H&H Thai Dried Honey Mango--->H&H 泰国蜂蜜芒果干
H&H THAI DRIED YOUNG COCONUT--->H&H 泰国椰子干
T&T Milk Cracker--->T&T 牛奶饼乾
T&T Pure Canola Oil--->T&T 纯芥花籽油
Um Milled Roasted Flax Seeds--->UM香煎纯亚麻籽
KINGO DRIED RED SKIN PEANUT--->金榖红衣花生
KINGO DRIED LONGAN--->金谷桂圆肉
Qijiwei Dried Green Raisins--->奇之味青提子
TOP CHOICE HAWTHORN SANDWICH--->华鼎牌山楂酪
TOP CHOICE HAWTHORN JELLY CANDY--->华鼎牌山楂饴
Lee Kum Kee Seasoned Soy Sauce For Seafood--->李锦记蒸鱼豉油大
GOLDEN NEST LYCHEE SWALLOW NEST BEVERAGE--->金燕窝荔枝燕窝饮
TONGYI XIAOMING YORGURT FLAVOR TEA--->小茗同学溜溜哒茶
Steamed Bbq Pork Bun-4 Pcs (Cold)--->叉烧包-4件 (冷)
Watercress--->西洋菜
Fz Golden Pompano--->急冻金鲳鱼
Hung Wang Fo Dumpling / Perogy Wrappers--->鸿运 饺子皮
TEN TEN WHOLE WHEAT BUN--->天天全麦馒头
WZW FISH BALL W/MEAT--->丸中王福州鱼丸
A-Dong A.D. Sausage--->东亚腊肠
ROYAL BBQ PORK SAUSAGE--->金冠切肉肠
100% Jumbo Shrimp Wonton--->百份百大虾云吞
Wing Hing Black Soy Beverage -Sweet--->永兴滋补黑豆浆-甜
SUNRISE FORTIFIED SOYA BEVERAGE LIGHT--->日昇低糖高钙豆浆皇
NORTHERN FOOD SPICED BEAN CURD--->丰业五香素鹅
T&T Fresh Tofu--->T&T鲜豆腐
Yang Shrimp Pork And Leek Dunmpling--->杨师傅三鲜水饺
Han-Ka Cut Kimchi- S--->韩家韩国泡菜- 小
NEILSON NLS 4L 3.25% ORG MILK - BAG--->NS有机全脂鲜奶
Burnbrae Farms Naturegg Free Run- L--->BF走地鸡鸡蛋-大
T&T Pork & Cabbage Dumplings--->T&T白菜猪肉水饺V
BINGGRAE MELONA MELMON ICE BAR--->冰极蜜瓜冰棒
SAMLIP UDON NOODLES--->三立鲜乌冬
T&T Layered Green Onion Pie--->T&T千层三星葱拉饼
Tenten Prok&Chinese Cabbage Dumpling--->天天白菜猪肉饺
CROWN IMITATION CRAB STICK--->皇冠蟹条
ITO EN JASMINE MATCHA GREEN TEA BAG--->伊藤园茉莉抹茶包
LAOHENGHE YELLOW COOKING WINE--->老恒和烹饪黄酒
TUNG FUNG ORGANIC MILLET--->同丰有机小米
Kao Liese Bubble Hair Color Natural Mocha--->花王泡沫染发摩卡
Kao Liese Bubble Hair Color Cocoa Brown--->花王泡沫染发可可棕
Kao Liese Bubble Hair Color Royal Brown--->花王泡沫染发高贵棕
LAOHENGHE SHAOXING SALTED COOKING WINE--->老恒和绍兴花雕酒
HAMADA CALCIUM MILK WAFER--->滨田补钙牛奶威化
SANA NAMERAKA ISOFLAVONE COENZYME Q10 FACIAL WASH--->莎拿豆乳Q10洁面乳
Wang Cheese Mini Fish Sausage--->皇牌芝士迷你鱼肠
DR.JART BRIGHTENING SOLUTION MASK--->DR.JART微晶亮白面膜
Panasonic Compact Nanoe Hair Dryer Ehna27--->松下便携离子风筒
ALL PLUS ST LEARNING CHOPSTICKS-PORORO--->AP儿童学习筷
VACUUM CUPPING--->吕式真空拔罐器
SKYFLAKES SWEET BUTTER SANDWICH BISCUIT--->空中奶油夹心饼乾
OSK KUMAMOTO MUGICHA BARLEY TEA BAG--->日本熊本熊袋泡麦茶
Minon Amino Moisturizing Face Mask--->MINO氨基酸保湿面膜
Kinomegumi Tree Extract Foot Patch - Artemisia--->树之惠美人艾草足贴
Kinomegumi Tree Extract Foot Patch - Lavender--->树之惠美人熏衣草足贴
Haday Premium Soy Sauce--->海天味极鲜酱油
DARIYA SALON DE PRO THE CREAM HAIR COLOR #5 BROWN--->达雅SALON DE PRO染发剂#5自然棕
FULINMEN ORGANIC SHORT GRAIN RICE--->福临门有机大米
CHRISTIE ORIGINAL OREO--->丽斯原味奥利曲奇
T&T BBQ STEAMED BUN - 6PCS--->T&T叉烧包-6PCS
Green Onion--->青葱
Synear Pork Soup Dumpling--->思念猪肉小笼汤包
T&T Edamame--->T&T 毛豆荚
T&T Black Pepper & Green Onion Pancake--->T&T 黑胡椒青葱烧饼
T&T Fish Cake With Mushroom--->T&T香菇鱼豆腐
T&T Organic Edamame--->T&T有机毛豆夹
Synear Pork & Cabbage Dumplings--->思念猪肉白菜灌汤水饺
T&T Organic Firm Tofu--->T&T有机卤水豆腐
Organic Chicken Wing--->特选有机鸡翼
Sun On Pre-Cooked Noodles--->新安 港式油面
NORTHERN FOOD SOYA BEANCURD STRIPS--->豐業原味干絲
T&T MEDIUM FIRM TOFU--->T&T 板豆腐
Bbq Duck Whole--->烧鸭-全只
Soy Chicken-Whole--->豉油鸡-整只
Pork/Shrimp/Chive Dumpling Raw--->手工韭菜三鲜水饺(生)
T&T Chinese Style Sausage-Pork--->T&T中式腊肠-猪肉
Milk Bread--->鲜奶方包
Raisin Tray Bun--->提子小餐饱
Sweet Egg Bread--->鸡蛋甜方包
Coconut Bread--->椰丝方包
Deluxe Seafood Platter--->海鲜拼盘
Fresh Chicken--->新鲜无荷尔蒙走地鸡
Fz Jumbo Scallop U10--->急冻珍宝大带子U10
KOLOKO SPICY PEA CRACKERS--->可乐果酷辣豌豆酥
TIGER BRAND HSINCHU RICE NOODLES--->虎牌新竹米粉
Glico Pocky Mango Biscuit Stick--->固力果芒果百奇
T&T Rice Husk Spoon--->T&T稻壳汤勺
T&T RICE HUSK COLANDER--->T&T稻壳漏勺
MARYYA DEWATERING MOP--->美丽雅甩水拖把
WUMU HUA-DIAO NOODLE--->五木花雕面
DASHANHE DRIED LONGAN PULP--->大山合1级圆肉
Want Want Chocolate Brownie Wafer Roll--->旺旺巧克力黑白配
Want Want Hot Kid Milk Flavour Cookie Ball--->旺仔牛奶小馒头
Three Squirrels Macadamia Nut--->三只松鼠夏威夷果
TAMANOHADA LIQUID BODY WASH 004 GARDENIA--->玉肌沐浴露004栀子花
Jm Solution Marine Luminous Pearl Sun Spray--->JM SOLUTION海洋珍珠防晒喷雾
La Mo Wang Bbq Flavoured Dried Tofu--->辣魔王烧烤素牛排
SUNSTAR SALT CARE TOOTHPASTE--->SUNSTAR当归护龈牙膏
DIANE BOTANICAL REFRESH & MOIST BODY WASH--->黛丝恩天然草本保湿沐浴露
Haday Bean Paste--->海天原酿豆瓣酱
Clorox Liquid Bleach Concentration 710Ml--->CLOROX消毒漂白液710ml
Gam Ma Bou Thai Fragrant Rice 8Kg--->金孖宝泰国香米8kg
T&T Organic Chestnut Gift Box--->T&T有机栗子礼盒
PRB CRYSTAL WHITE SUGAR--->珠江桥水晶白冰糖
KIKKOMAN MEMMI SAUCE--->万字面汁
NS CUP NDL-KIMCHEE--->农心泡菜杯面
SIX-F CHINESE SPICE POWDER--->六福五香粉
G&L Fz Basa Steak--->特级龙利鱼扒
Frz. Squid Tube--->急冻鱿鱼筒
Top Chef Perch Fillets Value Pack--->野生红斑柳家庭装
Red Delicious Apple(Around 0.7Lb/Each 4 Pcs Per order)--->高级红苹果
Fuji Apple(4Pcs/Around 3 Lbs)--->富士苹果(4个/约3磅）
Vine Tomatoes--->带茎蕃茄
TROPICANA PURE ORANGE JUICE--->TROP纯橙汁(６枝装)
LONGANISA (HOT) BULACAN--->菲式香肠-辣
Hung Wang Fo Cantonese Style Steamed Noo--->鸿运 鲜熟蛋炒面
Turnip Cake Supreme--->顶级萝卜糕-冷
Yo Black Bean Milk--->贤安黑豆浆淡
Activia Strawberry/Vanilla--->综合水果优格
Wzw Beef Balls W/Meat--->丸中王有馅牛肉丸
HM PORK BELLY IN & SKIN ON--->合利五花腊肉
KINGS COOK GREEN ONION PIE--->金品葱油饼
TYJ SPRING ROLL PASTRY 10IN--->第一家春卷皮10IN
NESTLE DRUMSTICK S-DIPPED COOKIES--->雀巢奥利奥甜筒
EV FZ. CLAM MEAT 200/400--->EV急冻蚬肉
YANG PORK&CELERY DUMPLING--->杨师傅猪肉芹菜饺
SANQUAN BLACK SESAME FILLING RICE BALLS--->三全黑芝麻汤圆
Walls Heytea Cheese Peach Ice Cream--->可爱多喜茶芝芝桃桃
Bbq Pork--->蜜汁叉烧
Pork Belly Boneless--->新鲜五花肉
Chicken Drumsticks--->小鸡腿
IDEAL TAPIOCA STARCH--->理想牌生粉
YAMASA SOY SAUCE LOW SODIUM-PLAS--->山字低盐酱油
AROY-D COCONUT MILK-FOR COOKING--->阿罗地烹调椰奶
SAVOY COCONUT CREAM--->SAVOY椰奶
CAMPBELL LOW SODIUM BEEF BROTH TETRA--->金宝低盐纸包牛汤
CHUANQI SEAFOOD HOTPOT SEASONING--->川崎海鲜火锅调料
DEEP MANGO PULP--->DEEP芒果浆
WANG ORIENTAL STYLE NOODLE--->皇牌乌冬面
PORTHOS SARDINES IN HOT TOMATO SAUCE--->老人牌辣番茄沙丁鱼
PAN GAO SHOU SHEDAN HERBAL JELLY--->潘高寿蛇胆枇杷膏
XPL BEAN CURD WITH CHILI--->江记麻油辣腐乳
CHEEZHENG TIBET HERBAL PATCH--->奇正消痛贴膏
GOLDEN APPLE SWEET FLOUR PASTE--->金苹果酱皇甜面酱
CHUANNAN TASTY VEGETABLE GO WITH MEAL--->川南爽口下饭菜
CHUANNAN SICHUAN PICKLED VEGETABLES--->川南四川泡菜
CHUN SI HE NAN STYLE NOODLE--->春丝河南手干面
LEE KUM KEE SUPREME SUSHI SOY SAUCE--->李锦记金酱油
WANG ASIAN STYLE NOODLE(MAK KUKSOO)--->皇牌韩国素面
HEYU DRIED LILY FLOWER--->禾煜黄花菜
NONG SHIM SOON VEGGIE NOODLE--->农心纯蔬菜汤面
DMDQ BROWN SUGAR--->东明大桥纯正红糖
TUNG-I BEEF & VEG CUP NOODLE-3 CUPS--->来一客牛肉蔬菜组
MASTER KON BLACK PEPPER BEEF NOODLE--->康师傅胡椒牛排面
Honey Chicken Leg - Rtc--->蜜汁鸡腿-预腌
Bean Curd W/Mushroom--->香菇腐皮卷
DUROYAL TARO FLAVOUR ICE MOCHI DESSERT--->DUROYAL TARO FLAVOUR ICE MOCHI DESSERT
Shallot Noodle With Crayfish--->厨厨葱油龙虾拌面
SAN SUI SOFT TOFU--->SAN SUI SOFT TOFU
Oinarisan Misuzu16pcs--->附味寿司豆腐皮
I-MEI SESAME GLUTINOUS RICE BALL--->I-MEI SESAME GLUTINOUS RICE BALL
Hikari Miso Organic White--->HIKARI有机白味噌
Becel Soft Butter Tub--->BECEL植物奶油
Shirakiku Konnyaku-Black--->白菊印黑蒟蒻
FROZEN SQUID TENTACLES--->急冻鱿鱼须
ASIAN LEGEND PICKLED BEANS MINCED PORK T--->ASIAN LEGEND PICKLED BEANS MINCED PORK T
HO MAY DOU MINCED PORK PICKLED CN VEG--->HO MAY DOU MINCED PORK PICKLED CN VEG
T&T CABBAGE&PORK STEAMED BUN--->T&T CABBAGE&PORK STEAMED BUN
PILLERS MAPLE HAM--->PILLERS MAPLE HAM
Pork Shoulder Butt--->叉烧肉
Original Mousse Mochi Cake--->牛奶慕斯白玉卷
T&T Pork Leek Dumpling--->T&T猪肉韭菜灌汤水饺
Unagi Crab Meat Sushi Roll--->鳗鱼蟹肉卷
Grill Eel (Previously Frozen)--->烧烤鳗鱼
Pork Side Ribs- Centre Cut--->精切大排骨条
Live Mussel--->生猛游水淡菜
Truedan Brown Sugar Mochi Dessert--->珍煮丹黑糖牛奶大福
Dr.Jart Cicapair Calming Mask--->DR JART积雪草抗痘面膜
DOLE APPLE WATER JELLY--->DOLE果汁果冻-苹果
WU XIAN ZHAI NUMB SPICY DIRED TOFU--->五贤斋麻辣素牛肚
SUNITY COFFEE FLAVOUR HERBAL JELLY--->生和堂咖啡龟苓配
JULIANG WILD GUM TRAGACANTH--->巨量天然野生雪燕
Botanist Botanical Moist Shampoo--->植物学家保湿洗发水
SVELTY 3 TIMES PAKKUN YEAST ENZYME--->SVELTY三倍糖质分解
Jayjun Real Water Brightning Black Mask--->JAYJUN水光面膜三部曲
Calbee Honey Butter Chips--->卡乐B 蜜黄油薯片
UTENA PURESA ROYAL JELLY GEL MASK--->佑天兰蜂王浆果冻面膜
KOPIKO BROWN COFFEE--->KOPIKO即溶3合1咖啡
P&G Floral Fragrance Laundry Detergent--->宝洁花果香柔顺洗衣液
GREAT MOUNTAIN GINSENG ROOT POW--->大山行花旗参粉
T&T RICE STICK- THIN--->T&T沙河粉-细
GREENMAX PURPLE RICE & BLACK SESAME CEREAL--->马玉山紫米芝麻糊
T&T TERIYAKI MARINADE & SAUCE--->T&T 日式照烧酱
GANZHIYUAN BROWN SUGAR WITH E JIAO--->甘汁园阿胶红糖
Pacific International Premium Dried Shrimp--->太平洋特级虾皮
Uncle Bill Seal Oil--->标叔海豹油500S
Papa Recipe Bombee Honey Hydrating Mask--->春雨蜂蜜经典保湿面膜
Papa Recipe Bombee Manuka Honey Cleansing Mask--->春雨黑卢卡蜂蜜清洁保湿面膜十片装
COW MILKY MILD SOAP BODY WASH--->牛牌温和皂香保湿沐浴露
WANT WANT HOT-KID QQ ORANGE GUMMY--->旺旺QQ香橙软糖
WANT WANT HOT-KID QQ GRAPE GUMMY--->旺旺QQ葡萄软糖
Angus Beef Striploin Steak--->顶级安格斯纽约牛扒
Charcoal Black Sesame Cake Square--->竹炭黑芝麻蛋糕砖
Seoul Matcha Bun--->首尔抹茶包
Deluxe Kogiku Sushi Set--->小菊寿司
Marinated Beef Shank Spicy With Special Sauce--->川味酱牛腱
Pork W/Watercress & Duck Glazard--->西洋菜鸭肾猪展汤
Yangzhou Fried Rice-S--->扬州炒饭-小
Fried Noodles W/ Bbq Pork -S--->叉烧肉豉油皇炒面-小
Triple Cheese Golden Bread--->芝士黄金砖
Mango Cake--->芒果蛋糕
Mango Swiss Roll W/ Pattern Surface--->芒果虎皮瑞士卷
Short Bread Cookie--->玛俐酥
Milk&Butter Cookie--->迷你牛油曲奇
Date Pastry--->枣泥酥4件
Custard Bun--->克林母包(奶黄包)
Fish Fillet W/ Hot Sauce--->水煮鱼片
Fish Fillet Pickled Style--->酸菜鱼片
Mushroom&Bamboo Bun-4Pcs (Cold)--->香菇笋丁包4件(冷)
Teriyaki Chicken Bun-4Pcs (Cold)--->照烧鸡肉包4件(冷)
PORK LEGS(SKINLESS BONELESS)--->豬腿瘦肉
PORK SIDE RIBS - BBQ STYLE--->新鲜精切排骨烧焗
ZHEN XIANG ROASTED DUCK FLAVOUR SOY PROTEIN MEAT--->祯香风味烤鸭素肉
Nihon-Yakken Golden Barley Grass Powder 100%--->金的青汁大麦若叶
BEIMEN DRIED BEANCURD STICK--->北门石屏腐竹
MYLAND BAMBOO STEAMER-6 INCH--->美耐6寸竹蒸笼
Prima Taste Laksa Whole Grain La Mian--->百胜厨叻沙全麦面
TAMANOHADA SHAMPOO 002 MUSK--->玉肌无硅洗发水002麝香
JULIANG ORGANIC BLACK JASMINE RICE--->巨量有机黑香米
TECO CELL PHONE CHARGING CABLE 1M--->TECO充电数据线1M
Okamoto 0.02 3 Pieces--->冈本0.02三片装
Okamoto Condom 0.01--->冈本0.01保险套润滑
T&T 3 In 1 Milk Tea--->T&T三合一奶茶
THERMOS THERMOCAFE STAINLESS STEEL CARAFE--->膳魔师保温茶壶
Kobayashi Lingerie Soap Blood Stain Remover--->小林制药内衣洗剂
Uyeki Anti-Mites Deodorization Spray--->UYEKI除蟎喷雾
MASTERKON JAPANESE STYLE PORK RIB NOODLE--->康师傅日式豚骨面
Cj Lion Lemon Foam Handsoap--->常绿秀柠檬泡沫洗手液
CJ LION ORGANIC GREEN TEA DISH DETERGENT--->常绿秀有机绿茶洗碗精
T&T Maple Flavoured Beef Jerky--->T&T枫糖牛肉乾
T&T Spicy Beef Jerky--->T&T麻辣牛肉乾
Lays Spicy Pot Flavour Potato Chips--->乐事麻辣香锅薯片
Juliang Wild Double Clip Saponins--->巨量野生皂角米
SHISEIDO TSUBAKI PREMIUM REPAIR HAIR MASK--->资生堂思波绮金耀瞬护发膜
Ferrero Collection T24--->金莎三色金钻礼盒
Vt Cica Moisture Mask--->VT CICA老虎补水面膜
PORK BACK RIBS--->小背脊肉排
RWA PORK BLADE BONE--->全自然西施骨
RWA PORK SHOULDER COLLAR BUTT--->全自然梅頭瘦肉
KOREAN PORK BELLY SLICE--->韓式五花肉卷
FRESH BEEF OXTAIL--->新鲜牛尾
GROUND LAMB--->絞羊肉
CHICKEN WINGS--->鸡全翼
RWA PORK SIRLOIN BLS--->全自然嫩猪瘦肉
BEEF TENDON--->牛筋
BEEF OMASUM--->牛柏叶
FROZEN LAMB SHANK--->急凍羊腱
QUAIL (567G)--->鹌鹑(6只)
BEEF TENDON BALL--->牛筋丸
JELLYFISH SLICE SALTED--->盐渍海蜇丝
FZ TURBOT H/G--->急冻北极桂花鱼
CABBAGE--->椰菜
CARROT--->红萝卜
POTATOES--->土豆
FRESH CAULIFLOWER--->富貴花
Tomato--->蕃茄
YUKA ROOT--->木薯
SEEDLESS BLACK GRAPE--->无籽黑葡萄
Barlette Pear--->尖啤梨
GOLDEN HAMI MELON--->黄金哈密瓜
Vt Cica Tone-Up Mask--->VT CICA老虎积雪草提亮面膜
Dr Wonjin Hyal-Moisture Remedy Mask Set--->原辰补水面膜套装(送洁面)
Sunity Lotus Seed Chinese Herbal Jelly--->生和堂莲子龟苓膏
Nestle Hojicha Kitkat--->雀巢日本煎茶奇巧
Zhang Jun Ya Spicy Flavour Noodle Snack--->张君雅麻辣风味丸子
MISE EN SCENE HELLO BALLET PINK 11P--->爱茉莉芭蕾粉染发剂11P
LEE KUM KEE SICHUAN SPICY NOODLE SAUCE 233g--->李锦记四川担担麵酱233g
LEE KUM KEE SRIRACHA CHILI SAUCE 435ml--->李锦记是拉差辣酱435ml
Glico Roast Pretz--->日本固力果烧烤百力滋
MZY DRIED MARINATED MUSTARD--->美之味客家梅菜干
TAIZHENXIANG SPICY DRIED BEANCURD--->太珍香烧辣乾豆干
MARUKYO PANCAKE DORAYAKI--->丸京松饼铜锣烧
LEE KUM KEE PURE BLACK SESAME OIL 207ML--->李锦记极纯黑芝麻油207ML
QI JING YUAN DIRED LILY--->琦鑫源四川黄花菜
WEI-LONG SPICY BEANCURD STICK--->卫龙香辣腐竹
JI YANG XUAN LIUZHOU SPICY RICE NOODLES--->寄杨轩麻辣螺蛳粉
WEI-LONG HAND TORN VEGETARIAN MEAT--->卫龙手撕素肉
WEI-LONG FISH TOFU--->卫龙鱼豆腐
Xiang Piao Piao Taro Milk Tea--->香飘飘香芋奶茶
Want Want Original Flavor Golden Rice Crackers--->旺旺小小酥原味经济包
Happy Days Goat Milk Powder 400G--->加拿大山羊奶粉400g
Great Mountain Ontario Ginseng Bag--->大山行袋装泡参
Yyws Chongqing Instant Noodle--->曹操饿了小面碗面
SHANGHAI BOK CHOY--->上海白菜
Kale--->甘蓝菜
WINTER DATE--->冬棗
FUJI APPLE(CHINA)--->中国富士苹果
HAYDEN MANGO BOX--->墨西哥芒果-箱
3 FISH FROZEN BABY CUTTLEFISH--->三魚牌急凍小墨魚
GRAND MAPLE BASA FILLETS--->枫华龙利鱼柳
Taro Bread--->芋头方包
Raisin Plain Loaf--->提子排包
Vietnamese Sandwich-Spicy--->越式三明治-辣
Crispy Chips Garlic--->香脆巧果-蒜味
Bbq Pork Bolo Bun--->菠萝叉烧饱
Milk Crispy Crust Danish--->牛奶菠萝长奶酥
Palm Leaf--->蝴蝶酥
Haidilao Soy Sauce Grilled Fish--->海底捞酱香烤鱼套餐
Japanese Pork Ramen Soup--->日式叉烧拉面
Diy Sushi Pack Starter--->自作首创寿司
Spicy Chicken W/ Chili- Large--->辣子鸡丁 - 大盒
Simulated Lobster Ball--->仿龙虾丸
Frozen Cooled Crayfish--->一桶江湖十三香龙虾
Abalone In Scallop Sauce--->乾贝汁烧鲍鱼
Eggplant--->紫茄
Italian Squash (Zucchinis)--->意大利瓜
Jumbo Mushroom--->特大磨菇
Yyws Chicken Flavour Instant Noodle--->曹操饿了黄焖鸡碗面
Juliang Organic Dried Red Bean--->巨量有机赤小豆
Fan Sao Guang Sichuan Pepper Pickles--->饭扫光麻辣什锦
Fan Sao Guang Preserved Bamboo--->饭扫光野竹笋
Dr Wonjin Moisture Remedy--->原辰补水保湿面膜
Zdl Pickled Pepper--->真的老泡小米辣
De Zhuang Mapo Tofu Seasoning--->德庄麻婆豆腐调料
Energy Beef Instant Noodle--->食族人牛肉私房面
Zdl Preserved Sour Radish--->真的老泡酸萝卜
Dongwon Vegetables Congee--->东远鲜蔬粥
Dongwon Chestnut Red Bean Congee--->东远板栗红豆粥
Ryo Damage Care Shampoo--->吕高效修护洗发水
Tong Yi Spicy Pork Bone Flavor Noodle--->统一酸辣豚骨碗面
Fhs Hot Sesame Paste Gluten--->凤回首麻辣麻酱面筋
Phyto Nutrients Shl Cold & Flu Formula--->PN双黄连超浓缩液
Unico Crushed Tomatoes--->原力高番茄蓉
Y&Y U.S. Sweet Rice--->如意牌美国糯米
Nishiki Premium Rice--->锦字特选米
Dan-D-Pak Natural Salted Pistachios--->丹蒂盐味开心果桶
WANJASHAN RICE VINEGAR--->万家香糯米醋
RICE SHAUHING COOKING WINE--->红万寿厨用绍兴
UFC CANTON NOODLE--->菲式即食广东面
Wu-Mu Wide Dried Noodle--->五木山东拉面粗条
Kraft Light Peanut Butter--->卡夫低脂滑花生酱
Pork Ribs W/Pre. Black Beans--->豉汁蒸排骨
General Tso Chicken-Large--->左宗棠鸡-大盒
Assorted Bean Curd - 2Items--->斋卤味双拼
Watson Nanjing Style Salted Duck--->华生南京盐水鸭
Gala Apple Bag--->袋装基拿苹果
Long Feng Cheese Fish Ball--->龙凤双飨起司鱼丸
Gyf Chestnut Roasted With Sugar--->宫御坊即食糖炒栗子
Teriyaki Chicken Don--->日式烧鸡饭
Kumiawase Sushi Set--->什锦玉子寿司
Favorite Assorted Sushi Tray--->和扇寿司派对盘
Pomelo (Red)-Box--->三红蜜柚-箱
T&T Organic Brown Eggs-M--->T&T有机黄鸡蛋中
Kung Fu Duck Spicy Sweet Duck Clavicle--->精武甜辣鸭锁骨
Beidahuang Organic Mixed Vegetable--->北大荒有机混合蔬菜
Dxc Mixed Nuts Rice Ball--->稻香村五仁汤圆
Dxc Red Bean Rice Ball--->稻香村豆沙汤圆
Dxc Black Sesame Rice Ball--->稻香村黑芝麻汤圆
Duroyal Brw Sg Pearl Mt Ice Dessert--->杜老爷冲绳黑糖珍奶冰
T&T Butter And Milk Scone--->T&T奶酥烤饼
Portuguese Tart W/Pearl-1Pc--->黑糖珍珠塔-1件
Egg Tart(Orignal)-Cold 1 Pc--->原味酥皮蛋塔-1件
SIX FORTUNE POTATO POWDER--->六福太白粉
Knorr Chicken Broth Cube--->家乐鸡精
KNORR PORK BOUILLON CUBE--->家乐猪肉精
SHINSHUICHI GREEN ONION MISO SOUP--->神州一青葱味噌汤
Shinshuichi Seaweed Miso Soup--->神州一海带味噌汤
Kraft Smooth Peanut Butter--->卡夫香滑花生酱
BILLY BEE LIQUID HONEY-UPSIDE DOWN--->BILLY BEE天然蜂蜜倒装瓶
AROY-D YOUNG GREEN JACKFRUIT IN BRINE--->阿罗地清水青菠萝
TIGER ELECTRIC GRILL PAN & HOT POT--->虎牌两用火锅
SENORITA DRY PEAS--->乾豆罐头
Lee Kum Kee Pure Sesame Oil--->李锦记纯正芝麻油
TONGXIANG PRESERVED PLUM--->同享九制话梅
MIZKAN RICE VINEGAR--->味滋康日本米醋
PEARL RIVER BRIDGE DARK SOY SAUCE--->珠江桥牌老抽
AMOY SOY GOLD LABEL LIGHT SOY SAUCE--->淘大金标生抽
Lee Kum Kee Panda Oyster Sauce--->李锦记熊猫蚝油
Lee Kum Kee Char Siu Sauce--->李锦记叉烧酱
Lee Kum Kee Panda Brand Oyster Sauce--->李锦记熊猫蚝油
Handy Twine--->棉绳
LADYS CHOICE SANDWICH SPREAD--->丽采三文治酱
LEE KUM KEE CHILI GARLIC SAUCE--->李锦记蒜蓉辣椒酱
COCK SWEET CHILI SAUCE FOR CHICKEN--->鸡标甜辣烧鸡酱
Lb Maple Syrup--->LB MAPLE枫叶糖浆
Salted Egg Yolk Tart-6 Pcs--->金沙蛋塔-6件
Hons Roasted Walnut Dessert--->汉记生磨核桃糊
Sunon Taiwanese Beef Noodles--->新安台式牛肉面
Marinated Beef & Tripe--->夫妻肺片
Fresh Sea Bream European--->新鲜银立鱼
Asian Legend Pork&Chive Dumplings--->味香村鲜肉韭菜饺
Pomelo-Yellow Gift Set--->礼盒装金柚
Salmon Teriyaki Don(Cold)--->照烧三文鱼饭(冷)
Ning Chi Korean Army Stew Pot--->宁记韩国部队锅
Coconut Egg White Tart-6 Pcs--->椰香蛋白塔-6 Pcs
Portugue Corn Ham Egg Tart-6 Pcs--->葡式玉米火腿沙拉蛋塔-6件
Korean Seasoned Wild Bracken Pickles--->韩式腌野蕨菜
Korean Seasoned Tribute Dish Root--->韩式腌贡菜根
Korean Shredded Squid--->韩式鱿鱼丝
Korean Soy Braised Kombu--->韩式海带丝
Pacific Rose Apple-Clamshell--->盒装玫瑰红苹果(每单限购1份)
Frz. Squid Ring--->急冻鱿鱼圈
Gala Apple--->基拿苹果
Hung Wang Fo Pre-Cooked Noodles--->鸿运 上海油面
Sun On Shanghai Style Noodle--->新安上海幼汤面
Hime Ginger Ice Cream--->姬生姜雪糕
Siwin Traditional Chili Sausage--->喜之味香辣烤肠
LESLIES CLOVER CHEESE CORN CHIPS--->LESLIES芝士味粟米片
HADAY SUPERIOR DARK SOY SAUCE--->海天老抽王
GOLDEN BONBON ALMOND NOUGAT CRUNCHY CANDY--->加宝硬鸟结糖
Christie Doyne Mini Oreo Cookie--->奥利迷你原味曲奇
UHA GRAPE STICK CHEWY CANDY--->味觉提子条装软糖
DEL MONTE CREAM STYLE CORN--->地扪粟米汤
AROY-D BAMBOO SHOOT-STRIPS--->阿罗地清水笋-丝
Greatwall Pork And Ham--->长城火腿午餐肉
GULONG FRIED SARDINES--->古龙鲜炸沙丁鱼
Want Want Fried Senbei Rice Cracker--->旺旺无聊派大仙贝酥
Soo Hot Five Spices Beef Jerky--->狮牌辣五香牛肉乾
Calbee Ethnicans Hot&Spicy Potato Chips--->卡乐B 热浪薯片
Brands Birds Nest Sugar Free--->白兰氏无糖燕窝
Garden Malkist Cracker--->嘉顿香麦芽酥
Lee Kum Kee Premium Dark Soy Sauce--->李锦记特级老抽
CANAAN GINGER TEA--->加南韩国生姜茶
Laoganma Salted Black Bean With Chili Paste--->老干妈风味豆豉
Holiday Luncheon Meat--->假日午餐肉
HEREFORD VIENNA SAUSAGE--->希福维也纳香肠
Lee Kum Kee Prem Flavour Bouillon Powder--->李锦记特级调味鸡粉
Soo Soft Shredded Pork (Bag)--->猪肉松( 包装)
Ryo Hair Care Special Value Set--->吕亮泽洁净超值套装
Ito Cleansing Towel--->ITO纯棉耐用洗脸巾
Kikkoman Soy Sauce--->万字酱油
KINGS COOK GREEN ONION PIE--->金品葱抓饼
HIME BLACK SESAME ICE CREAM--->姬黑芝麻雪糕
1ST CHOICE MAT KIMCHI SMALL--->第一选韩国泡菜小
Mengniu Vanilla Suibian Ice Bar--->蒙牛随变香草雪条
Walls Heytea Bubble Tea Ice Cream--->可爱多喜茶黑糖波波
Mengniu Green Red Bean Ice Bar--->蒙牛绿色心情红豆味
Ground Pork-Lean--->绞猪肉-瘦
Honey Chicken Wing - Rtc--->蜜汁鸡翼-预腌
ZLS DRY VEGETABLE PANCAKE--->张力生梅干菜锅盔
Hons Premium Chicken Potstickers--->汉记精选鸡肉饺子
WINTERMELON PASTRY (L)--->WINTERMELON PASTRY (L)
Frozen Cabbage&Pork Dumpling-24 Pcs--->高丽菜猪肉水饺-24个
Watson Dried Shrimp--->华生牌虾皮- 生干
PULMUONE ORGANIC TOFU (FIRM)--->PULMUONE ORGANIC TOFU (FIRM)
ORIGINAL MILK PUDDING--->ORIGINAL MILK PUDDING
LKF BLACK GLUTIN. RICE&SESAME RICE BALL--->LKF BLACK GLUTIN. RICE&SESAME RICE BALL
SIWIN MOZZARELLA JAPANESE SAUSAGE--->SIWIN MOZZARELLA JAPANESE SAUSAGE
Swicy Cooked Chinese Cabbage Pork Bun--->随喜白菜鲜肉包
LONG FENG SHRIMP DUMPLING--->LONG FENG SHRIMP DUMPLING
SYNEAR PORK&CELERY DUMPLING--->SYNEAR PORK&CELERY DUMPLING
ASIAN LEGEND RICE W CK BLACK PEPPER--->ASIAN LEGEND RICE W CK BLACK PEPPER
Plain Bread--->白方包
Mini Chocolate French Bread--->巧克法式面包小粒
Almond Cookie-M--->杏仁酥- 中
Okamoto Condoms Rilakkuma Honey Condoms--->冈本轻松熊温感保险套
Vinda Wet Wipe--->维达消毒湿巾
Kao Hot Eye Mask Lavender--->花王眼罩薰衣草
T&T Reduced Salt Roasted Seaweed Snack--->T&T低盐海苔
Windmill Beef Spice Pouch--->小磨坊牛肉卤包
Hoe Hin W.F.Embrocation--->和兴白花油(二号)
Ox Head Rice Paper--->牛头牌春卷皮
Coconnatade Cocoinsyrup Lychee--->可乐块装椰果-荔枝
Campbell Vegetable Broth--->金宝蔬菜清汤
Yu Yuan Pickled Cow Pea--->榆园东北酸豆角
Diamond Salted Shao Xing Cooking Wine--->钻石特级绍兴料酒
Campbell Low Sodium Vegetable Broth--->金宝低盐蔬菜清汤
Kikkoman Sweet Soy Sauce For Rice--->万字甜味拌饭酱油
Fishwell Preserved Vegetable--->鱼泉牌爽脆榨菜丝
Shiseido Shiny Shampoo Tsubaki--->资生堂植萃亮泽洗发
Shiseido Shiny Conditioner Tsubaki--->资生堂植萃亮泽护发
Shiseido Straight Conditioner Tsubaki--->资生堂植萃顺直护发
Fun Ye Fermented Bean Curd--->饭爷白方糟辣子腐乳
BOTANIST SMOOTH SHAMPOO--->BOTANIST SMOOTH SHAMPOO
Shinho Soybean Paste Combo--->欣和原味黄豆酱促销装
Wonjin Medi Energy Infusion Mask--->原辰吊瓶焕颜面膜
Youjia Five-Spice Powder--->友加五香粉
Youjia Cinnamon--->友加桂皮
Youjia Green Pepper--->友加青花椒
Rwa Chicken Minimum 2Lb--->全自然鸡 约2磅
Fresh Chicken-900 G--->黄油走地鸡-900克
Rwa Young Duck-A--->全自然A级嫩鸭
Konnyaku Vermicelli-Sm Bud--->健康芋丝-小扎
Ten Ten Steam Bun--->天天馒头
TEN TEN VEGETABLE & PORK BUN--->天天菜肉包
Wzw Pork Ball W/Meat--->丸中王福州贡丸
Wahaha Original Yogurt Drink--->原味乳酸饮料
Naturegg Omega 3 Brown - L--->奥米加大黄蛋
Organic Enoki Mushroom--->有机金针菇
SUNRISE UNSWEET SOYA BEVERAGE--->日昇豆浆皇-淡
Haagen-Dazs Ice Cream-Strawberry--->HD草莓雪糕
100% JUMBO SHRIMP DRIED SCALLOP WONTON--->百份百大虾瑶柱云吞
Likoufu Phoenix Custard Bun--->利口福凤凰流沙包
Jaten Squid Ball--->佳田花枝丸
T&T Green Onion Pancake--->T&T葱抓饼- 加葱8%
BINGGRAE BANANA FLAVOUR MILK DRINK--->冰极香蕉牛奶饮料
Lemon-Bag--->袋装柠檬
New Zealand Lamb Shoulder Roll--->纽西兰韩式嫩羊肉卷
Meixiang Cooked & Salted Duck Egg--->梅香熟咸鸭蛋
C.J. PORK&VEGETABLE BIG DUMPLINGS--->C.J.韩式猪肉菜饺
TENTEN PORK LEEK& EGG DUMPLING--->天天韭菜三鲜饺
Lsqie Plain Baked Yogurt--->LSQIE原味烤酸奶
T&T Fish Tofu--->T&T 鱼豆腐
Youjia Dahongpao Sishuan Pepper--->友加大红袍花椒
Wzh Red Beans Paste-Coarse--->王致和红豆馅(粗颗粒)
Mise En Scene Hb 3Nt Dark Choco--->美妆仙植物泡泡染发-深可可
Mise En Scene Hb 6N Choco Brown--->美妆仙植物泡泡染发-巧克力
Mise En Scene Hb 1B Mystic Black--->美妆仙植物泡泡染发-亮黑色
Meiji Chocolate Giant Hello Panda--->明治朱古力大熊猫饼干
Hrbl Vermicelli Classic Hot&Spicy--->嘿人部落酸辣粉
Enjoy Chenhua Soy Sauce Water Bamboo--->食在辰华红烧茭白
Yu Jia Xiang Fried Anchovies--->鱼家香美味凤尾鱼
Kao Bubble Color Milk Tea Brown--->花王泡泡染发-奶茶棕
Yyws Instant Noodle Spicy Beef--->曹操饿了香辣牛肉面
T&T Organic Mix Thai Rice--->T&T有机泰国混合米
GLICO MOUSSE MILK MANGO COOKIES--->固力果慕思芒果饼乾
Hsufuchi Pepper Crab Flavour Sachima--->徐福记胡椒蟹味沙琪玛
Non-Medical Adult Face Mask 10 Pieces--->一次性防护成人口罩10片
KUAI KUAI CORN BISCUIT- MILK--->乖乖炼乳玉米脆条
BALIS BEST ESPRESSO COFFEE CANDY--->芭里特浓咖啡糖
CHUN GUANG SUMIYAKI COFFEE CANDY--->春光炭烧咖啡糖
HHC CHICKEN FLV CRACKER--->嗄嗄叫麦香鸡块饼
KOLOKO PEA CRACKERS-LEMON PINK SALT--->可乐果豆酥- 柠檬玫瑰
GZY PEPPER OIL--->贡椒源花椒油
Lays Fried Crab Flavour Chips--->乐事金黄炒蟹味薯片
JFL DRIED RED DATES--->嘉福利新疆雪枣
CL DARK BROWN ORGANIC HERBAL HAIR COLOR--->CL深棕纯植物染发剂
Synear Shrimp & Scallop Dumpling--->思念金牌虾乾贝鲜虾饺
T&T Cooked Soy Beans--->T&T 毛豆仁
T&T Oven Baked Sesame Pancake--->T&T芝麻烧饼
T&T Layered Red Bean Pie--->T&T千层红豆拉饼
T&T Layered Sweet Potato Pie--->T&T千层地瓜拉饼
T&T Fish Cake Family Pack--->T&T鱼豆腐家庭装
T&T Chn Style Dried Pork Belly--->T&T 原味腊肉
Sun On Shaighai Dumpling Wrappers--->新安上海云吞皮
TYJ 6IN SPRING ROLL PASTRY--->第一家春卷皮6IN
T&T GYOZA (PORK & BEEF)--->T&T日式煎饺-猪牛
Chingping Chicken--->金枫清平鸡
Rosemary&Garlic Lamb Loin Chop--->香蒜迷迭羊扒
Romaine Heart Lettuce--->罗曼生菜包
Top Chef Pollock Fillets- Value Pack--->野生鳕鱼柳家庭装
Rosemary Garlic Lamb Racks--->蒜汁迷迭香羊架
Amoy Glutinous Rice Dumpling--->淘大至尊珍珠鸡
Chewy Instant Japanese Fresh Udon Noodle--->超力日式乌冬
SIMPLY ORANGE W/PULP--->SIMPLY有果粒橙汁
Watson Shrimp--->华生牌虾皮- 鲜
MEIJI UJIKINTOKI--->明治宇治金时冰棒
Bbq Pork+Duck Bento Box--->叉烧+烧鸭便当
Shanghai Bok Choy Sprout--->上海菜苗
Doll Rice Roll Shrimp--->公仔点心鲜虾肠粉
SYNEAR SESAME RICE BALL--->思念黑珍珠芝麻汤圆
HAGOROMO SHOYU SARDINE--->羽衣酱油沙丁鱼
XCZW DENDROBIUM FLOWER--->仙草之王石斛花
LION GLOBLE PEANUT OIL--->狮球唛花生油
BLACK GLUTINOUS RICE--->如意牌黑糯米
NISHIKI MAI RICE--->锦字寿司用米
GLUTINOUS RICE VINEGAR--->谷盛糯米酢
FIVE ROSES AL/PURP WHITE FLOUR--->五玫瑰万用面粉
COCK YOUNG GREEN JACKFRUIT--->鸡标青菠萝蜜
PORKWAN HOT SHRIMP PTE--->珀宽辣虾膏
OIL PRESERVED CABBAGE LEAF--->潮盛牌潮州橄榄菜
SHSHI VINEGAR--->谷盛寿司酢
OX HEAD BLK GLUTINOUS RICE--->牛头泰国黑糯米
LION&GLOBE PEANUT OIL-3L--->狮球唛花生油-3L
BAMBOE INDONESIAN FRIED RICE--->BAMBOE印尼炒饭调料
MAMA SITAS SISIG--->菲式碎肉混炒
JULIANG ORG MILLET--->巨量有机小米
LG PEANUT OIL--->龙港花生油
PC GRAPESEED OIL--->PC葡萄籽油
KINGO GLUTINOUS RICE (2KG)--->金谷糯米(2KG)
OX HEAD ORGANIC RED JASMINE RICE--->牛头有机泰红香米
FLM BRAND SUSHI RICE--->福临门寿司米
JULIANG ORGANIC MILLET--->巨量有机东北小米
Juliang Organic Corn Grits Small--->巨量有机玉米槮
PALDO KIMCHI RAMEN 115GX4--->八道泡菜先生汤面
COMBO SAUSAGE--->金冠精美腊味包
Wonton Wrapper--->海天云吞皮
HUNG WANG FO SHANGHAI-STYLE NOODLES--->HUNG WANG FO SHANGHAI-STYLE NOODLES
HUNG WANG FO WON TON NOODLES-THIN--->鸿运云吞面- 细
Sun On Wonton Noodles- Thin--->新安全蛋云吞面- 细
Sun On Shanghai Style Fried Noodles--->新安上海粗炒面
Unique Wonto Shrimp Shao Mai--->唯一 鲜虾烧卖
YOPLAIT STRAWBERRY YOGURT DRINK--->优沛蕾草莓酪乳
WING HING REGULER TOFU--->永兴包仔豆腐
Cwf Korean Style Beef Rib Eye--->韩式调味牛柳片
I-Mei Red Bean Milk Ice Bar--->义美红豆牛奶冰棒
MAEIL BIOFEEL YOGURT--->万朝乳酸奶
Yin On Sugar Free Soya Drink--->贤安淡豆浆
Hohoho Fish Ball--->好好好鱼蛋
Hohoho Cutle Fish Ball--->好好好墨鱼丸
I-Mei Frozen Waffle-Sesame--->义美抓饼
Sun On Shandong Style Noodles- Flat--->新安新鲜拉面- 扁
SUNRISE PREMIUM SOFT TOFU--->日昇西施豆腐
Uw Jumbo Shrimp Dumpling--->唯一大虾薄皮水饺
MYOJO NAMA YAKISOBA--->明星酱烧炒面
Unique Scallop Shrimp Wonton--->唯一带子鲜虾云吞
Binggrae Red Bean Bar--->冰极红豆冰棒
SUNRISE ORIGINAL TOFU DESSERT--->日昇原味豆腐花
Bolo Bun (HK Style)--->港式菠萝包
CALBEE BLACK PEPPER SNAPEA CRISPS--->卡乐B黑椒雪豆片
Lao Zhong Yi Cool Moisturizing Tea--->老中医清凉喉宝
MYLAND ELECTRIC HOT POT 28CM--->美耐鸳鸯电火锅
NONGFU SPRING PEACH OOLONG TEA--->茶派蜜桃乌龙茶
Unico Pure Corn Oil--->原力高纯粟米油
DMDQ RICE STICK--->东明大桥江门排粉
Prima Taste Chili Crab La Mian--->百胜厨辣椒蟹拉面
Chacha Spiced Sunflower Seeds--->洽洽五香瓜子
T&T Extra Hot Xo Sauce--->T&T 大辣XO酱
A-SHA ORIGINAL SEAWEED SNACKS--->阿舍原味夹心海苔
COW MILKY RELAX FLORAL BODY WASH--->牛牌治愈花香保湿沐浴露
HAPPY DRIED SWEET & SOUR PLUM--->欢乐一族酸梅肉
Jayjun Rose Blossom Mask--->JAYJUN红玫瑰面膜
GILIM WASABI ALMOND--->GILIM 芥末杏仁
Golden Nest Honey Sriracha Beef Jerky--->金燕窝蜂蜜是拉差牛肉乾
Dr.Jart V7 Toning Mask--->DR.JART V7 维他命亮白面膜
GREAT MOUNTAIN LESS SUGAR GINSENG COFFEE--->大山行低糖咖啡
Jutsuxian Shrimp Xo Sauce--->菊之鲜樱花虾XO酱
Tseng Noodles Scallion & Sichuan Pepper Flavor--->曾拌面-香葱椒麻
T&T 3In1 Coffee--->T&T三合一咖啡
T&T Shanxi Huping Red Dates--->T&T山西壶瓶枣
Shaerge Mixed Peanuts Crisps--->傻二哥什锦花生酥
SHAERGE MIX PEANUTS SNACK--->傻二哥什锦花生
Jm Solution Luminous Pearl Deep Moisture Mask--->JM SOLUTION珍珠保湿面膜
PILLERS KOLBASSA SAUSAGE--->PILLERS波兰特色香肠
I-MEI GRN TEA RED BEAN MILK ICE BAR--->义美抹茶红豆冰棒
Y.L.PRESERVED DUCK EGG--->Y.L.PRESERVED DUCK EGG
Tropicana Grape Juice--->TROP提子汁
Rimao Salad Bamboo Shoot--->日茂沙拉笋
SUN NOODLE MISO RAMEN--->一生味增拉面
Red Bean Danish--->丹麦长条红豆
NANXIANG SHEPHERDS PURSE BUN--->南翔荠菜包
Delizia Taiwanese Style Turnip Cake--->得易家台式萝卜糕
ASIAN LEGEND ASIAN STYLE THIN NOODLE--->味香村细面
MR LOSTER FLAVORED BALL--->满盛龙虾丸
Mr Cuttlefish Ball--->满盛墨鱼丸
RI WANG SOUPY BUNS W/PORK FILLING--->日旺南翔小笼汤包
BINGGRAE MELON FLAVOUR MILK DRINK--->冰极蜜瓜牛奶饮料
Sunnymark Dried Small Shrimp--->新唛特级虾皮
PULMUONE ORGANIC TOFU (SOFT)--->有机韩式软豆腐
DELIZIA MINI CUSTARD BAO--->得易家迷你奶皇包
NEILSON MICROFILTERED HOMO MILK - CTN--->NS过滤全脂鲜奶
NEILSON TTT 2L 1% LACTOSE/F MILK - CTN--->NS低乳糖1%鲜奶
1ST CHOICE MAT KIMCHI LARGE--->第一选韩国泡菜大
6 Inch Molten Mango Yogurt Cheese Cake--->6寸芒果流心蛋糕
ASIAN LEGEND FRIED NOODLES W/ SHREDDED CHICKEN--->ASIAN LEGEND FRIED NOODLES W/ SHREDDED CHICKEN
Binggrae Melona Mango Ice Bar--->冰极芒果冰棒
Ho May Dou Chicken Dried Lily Flower& Agaric--->HMD金针云耳蒸鸡
PH CARE FEMININE WASH FLOWER--->PH CARE 女性洗液玫瑰香
ARAU BABY LAUNDRY DETERGENT FOR BABY--->雅乐宝婴儿洗衣液
ZUBEDAH BLACK HENNA--->ZUBEDAH染发剂黑色
MEGUMI ONSEN TIGHTENING MASK--->惠之本舖温泉紧致面膜
SUNNYMARK SPICY FRIED FISH SKIN--->新唛辣椒香脆鱼皮
HACKERS CHENGDU STYLE SELF-HEATING HOT POT--->蜀客行串香自煮锅
Hackers Pickled Radish Duck Self-Heating Hot Pot--->蜀客行老鸭自煮锅
CJ LION J.APRICOT CHARM GREEN DISH DETERGENT--->常绿秀杏子洗碗精
RALSTON FOOD CLINGING WRAP--->RAIS保鲜膜带胶刀
Lays Cucumber Flavour Potato Chips--->乐事黄瓜味薯片
MEDALLION SKIM MILK POWDER--->麦德林脱脂奶粉
BAIJIA CHONGQING STYLE NOODLE--->白家重庆小面
T&T Organic Jasmine Rice--->T&T有机泰国天然香米
Vt Cica Pro-Cica Mask--->VT CICA老虎双倍补水面膜
Dr Wonjin Water Toning Essence Mask Set--->原辰修复面膜套装(送洁面)
Lion Foaming Hand Soap Fruit--->狮王水果泡沫洗手液
Lion Handsoap Lemon Refill--->狮王柠檬洗手液补充包
Sunity Linzhi Chinese Herbal Jelly--->生和堂灵芝龟苓膏
HF SAM/OELEK CHILI SAUCE (S/O)--->汇丰辣椒酱 S/O
LKK MINED GINGER--->李锦记姜蓉
SHINHO SWEET BEAN PASTE--->欣和葱伴侣甜面酱
ASIAN HOME GOURMET HAINANESE CHICKEN RIC--->佳厨新洲海南鸡饭酱
SSF SHRIMP NOODLES-THICK--->新顺福虾子面粗条
Homaydou Chicken Mushroom & Chinese Sausage--->HMD腊肠冬菇蒸鸡
Kings Cook Red Quinoa Green Onion Pancake--->金品红藜葱抓饼
North Shore Fishery Spiced Cooked Crayfish--->北洋海产十三香小龙虾
Thai Gold Durian Monthong Pulp W/ Seed--->TG金枕头榴梿肉
Nissin Bbq Bun--->日清港式叉烧包
NP GRASSLAND MILK ICE BAR--->东北大板草原奶冰棒
Sunshine Ranch Sliced Beef Roll--->阳光牧场牛五花
Binggrae Coconut Melona Coconut--->冰极椰奶冰棒
YA FANG RED BEAN & CONDENSED MILK ICE CREAM--->雅方红豆炼乳雪糕
CYNTHIA B.B.Q.PORK BUN--->嘉佳叉烧大包
Tilapia-Whole Box--->原箱鲫鱼
HD VANILLA ALMOND ICECREAM BAR--->HD香草杏仁雪条
NESTLE VANILLA DRUMSTICK--->雀巢香草甜筒
T&T Chinese Sausage(Chicken)--->T&T 瘦肉鸡肉腊肠
8 Inch Strawberry Party Cake--->8寸草莓派对蛋糕
Mixed Fruit Cake--->8X12 杂果蛋糕
Taro Pastry--->芋头酥-4件
OCEAN JEWEL ORGANIC MUSSEL MEAT - COOKED--->OJ有机青口肉-熟
SUPERIOR UNSWEETENED SOYA--->SUPERIOR UNSWEETENED SOYA
SF TW GARLIC PORK SAUSAGE--->樱花安康猪蒜味香肠
Strawberry Mousse Mochi Cake--->草莓慕斯白玉卷
Mango Mousse Mochi Cake--->芒果慕斯白玉卷
Brown Sugar Tapioca Swiss Roll--->黑糖珍珠瑞士卷
LKK DOUBLE FERMENTED SOY SAUCE--->李锦记双璜头抽
INST VEGETABLE SAUCE FERN--->饭扫光即食野蕨菜
INST VEG SAUCE CRISP TURNIP--->饭扫光即食脆萝卜
OX HEAD RICE PAPER 22CM--->牛头牌米纸
SEMPIO SOYBEAN PASTE--->泉字黄豆酱
MAMA TOM YUM INSTANT NOODLE PACK 5--->妈妈冬阴公虾面5PK
DELPHI SEA SALT--->DELPHI海盐
DRY MUSHROOM- LARGE SIZE--->埔里香菇- 大
KINGO DRIED RED CHILLI--->金谷红朝天椒
LEE KUM KEE BROWN COOKING SOY SAUCE--->李锦记红烧酱油
LAOGANMA OIL CHILI CONDIMENT W/MUSHROOM--->老干妈香菇油辣椒
HENGSHUN 8YEARS VINEGAR--->恒顺八年熟成香醋
NONG SHIM ANSUNGTANGMYUN MULTI--->农心安城汤面四包
DJJ DRIED BLACK BEAN FISH--->大酱军阴豉小鱼干
TUNG-I MINCED PORK CUP NOODLE-3CUPS--->来一客肉燥杯面组
SUNITY ROSELLE HERBAL JELLY--->生和堂洛神龟苓饮
DOLE PEACH WATER JELLY--->DOLE果汁果冻-水蜜桃
NISSIN UDON TOMATO BEEF FLVAOUR--->出前一丁番茄牛肉乌冬
LAVONS LAUNDRY DETERGENT CHAMPAGNE--->LAVONS香槟洗衣液
LEE KUM KEE SOYBEAN SAUCE 800g--->李锦记黄豆酱800g
Greenmax Roasted Black Soybean Milk Tea--->马玉山炭香黑豆奶茶
WU XIAN ZHAI SOY SAUCE DIRED TOFU--->五贤斋酱爆味素牛肚
SILVER SWAN SOY SAUCE--->天鹅酱油
T&T Almond Cracker--->T&T杏仁饼乾
T&T Pork Cabbage Dumpling--->T&T猪肉白菜灌汤水饺
Chicken Breast Skinless/ Boneless--->无皮无骨鸡胸肉
Don Gua--->中国冬瓜
Green Onion Roll (Cold)--->青葱花卷 (冷)
Cartoon Shape Steamed Bun--->可爱卡通包
Chili Chicken Feet With Garlic--->蒜香椒麻凤爪
Deep Fried Shrimps -S--->椒盐虾-小
Swiss Roll-Tree Skin Chocolate--->树皮巧克力瑞士卷
Meng Niu Mango Ice Plus Bar--->蒙牛冰+芒果雪条
Sesame Red Bean Pie--->相思红豆饼
Choco Hazelnut Swirl Bread--->朱古力榛子年轮面包
Panda Cookies--->熊猫饼乾
Plain Tray Bun--->小餐包
Peanut Cookie--->花生酥
Sesame Cookies--->芝麻酥
Hi-Cal Sesame Soymilk Bread--->高钙黑芝麻豆浆包
Cold Appetizer 5 Item Combo--->欢乐小菜 5格拼盘
Sweetened Condensed Milk Bread--->炼奶皇冠包
Tofu Bread--->豆腐方包
Classic Fruit Basket--->经典果篮
Pork&Pickled Chinese Mustard Buns-4Pcs (Cold)--->梅菜扣肉包4件(冷)
Mushroom Chicken Bun-4Pcs (Cold)--->香菇鸡肉包4件(冷)
DMDQ DRIED MUSHROOM--->东明大桥金钱菇
QIJIWEI COOKIES--->奇之味水泡饼
JULIE LEMOND PUFF SANDWICH--->朱丽柠檬夹心饼
SHINHO SWEET BEAN PASTE--->欣和六月香甜面酱
LION SYSTEMA KIDS TOOTHBRUSH OVER AGE 6--->狮王适齿美6嵗以上儿童牙刷
DAN-D-PAK ORGANIC QUICK OATS--->丹蒂有机快熟麦片
Health Style Sugar Free Black Sesame Powder--->健康时代无糖黑芝麻粉
MERILIN RADIX ASTRAGALI--->美林北氏
MATERKON HAOZIWEI BRAISED BEEF NOODLE--->好滋味红烧牛肉面
TASCO COCONUT WATER--->达斯克椰子水
Wedderspoon Raw Manuka Honey Kfactor16--->麦卢卡蜂蜜活跃16
MLS TAIWAN DRIED NOODLE--->万里香台湾花瓣面
MASTERKON HAOZIWEI SPICY BEEF NOODLE--->好滋味香辣牛肉面
SOO EXTRA HOT FIVE SPICE BEEF JERKY--->狮牌特辣五香牛肉乾
SUNTORY NON ALCOHOL UMESHU--->三多利无酒精梅酒
T&T Brown Rice--->T&T糙米
COPPERDRUM HONEY CASHEWS--->铜鼓蜜味烤腰果
SOFY OVERNIGHT COTTON SANITARY PADS 28CM--->苏菲超熟睡棉柔卫生棉28CM
Great Mountain Ginseng Soft Candy--->大山行花旗参软糖
Hadalabo Shirojyun Whitening Milk--->肌研白润美白乳液
HUNG FOOK TONG PEAR AND SEA COCONUT DRINK--->鸿福堂雪梨海底椰
Hetianyu Five Stars Red Dates--->和田玉五星级红枣
Qijiwei Egg Rolls--->奇之味葡式蛋卷
Hikari Mild Sodium Instant Miso Soup--->HIKARI即食味增汤低盐
Marinated Dish Combo-A--->卤味拼盘-A
BEEF EYE ROUND STEAK--->牛腿肉眼扒
LAMB SHOULDER B/S SLICE--->嫩羊肉片
CHICKEN LEGS(BACK ATTACHED)--->连背鸡腿
MEDITERRANEAN SEASONED LAMB LEG--->全自然無骨羊腿肉調味
SQUAB 350g--->乳鴿
CHICKEN LEG BONELESS/SKINLESS--->无骨无皮鸡腿
ROSEMARY&GARLIC LAMB RIBS--->迷迭香羊排
BABY CUTTLEFISH--->冰鮮小墨魚
Fresh Atlantic Salmon Steak--->新鲜大西洋三文鱼扒
LIVE LOBSTER-LARGE--->生猛游水大龙虾
LIVE GREEN BASS--->生猛游水青斑
LIVE LOBSTERS-MEDIUM(A GRADE)--->游水龍蝦 A級
CHIVE(NIRA)--->韭菜
CHINESE EGGPLANT--->中茄
Gai Lan Jr.--->芥兰苗
KABOCHA--->日本南瓜
LOTUS ROOT--->莲藕
RED BELL PEPPER--->红椒
Large Taro--->大芋头
S.Taro--->小芋头
KOREAN MELON--->韩国黄香瓜
BEAN SPROUT--->绿豆芽
FZ IMITATION CRABMEAT LEG STYLE--->急凍仿蟹柳
COPPERDRUM DRY ROASTED UNSALTED CASHEWS--->铜鼓原味非油炸腰果
DMDQ SOY SAUCE FLAVOUR WATERMELON SEEDS--->东明大桥酱油黑瓜
Haidilao Spicy Hot Pot Soup Base--->海底捞清油火锅底
Diamond G Brown Rice--->钻石G糙米
Prima Taste Curry La Mian--->百胜厨咖哩拉面
Taokaenoi Original Grilled Big Seaweed Roll--->小老板原味紫菜卷
Taokaenoi Big Seaweed Roll - Spicy Grilled Squid Flavour--->小老板鱿鱼紫菜卷
TOYAMA HORSE OIL BODY WASH--->富山马油沐浴露
MASTERKON HAOZIWEI PICKLED VEGETABLE & BEEF NOODLE--->好滋味酸菜牛肉面
T&T Organic Black Tea Bag--->T&T 有机红茶茶包
LEADERS COLLAGEN LIFTING SKIN RENEWAL MASK--->丽得姿胶原蛋白面膜
LEADERS ALOE SOOTHING SKIN RENEWAL MASK--->丽得姿芦荟舒缓面膜
Ujinotsuyu Genmaicha Roasted Rice Tea Bag--->宇治之露玄米茶包
SHINHO PREMIUM ORGINIAL SOY SAUCE--->欣和六月鲜特级原汁酱油
T&T Korean Style Sweet Potato Thin Vermicelli--->T&T 韩式红薯粉条(细)
T&T Korean Kalbi Marinade Sauce--->T&T 牛仔骨烤肉酱
T&T Korean Bulgogi Marinade Sauce--->T&T 韩国烤肉酱
Agf Blendy Stick Latte--->AGF拿铁即溶咖啡
T&T SRIRACHA ROASTED GREEN PEAS--->T&T 是拉差青豆
T&T ORIGINAL ROASTED GREEN PEAS--->T&T 原味青豆
T&T Organic Roasted Chestnut (In-Shell)--->T&T 有机带壳栗子
Shanyuan Dried Mushroom--->山缘金钱菇
T&T Non-Fried 3 Minute Ramen Noodles--->T&T3分钟非油炸拉面
T&T RICE STICK- THICK--->T&T沙河粉-粗
WHITE BEECH MUSHROOM--->白柳姬菇
AA-1 FZ HASA HASA--->AA-1急凍哈沙
LAMB LOIN CHOP--->T骨羊扒
Frozen Grilled Eel--->急冻蒲烧鳗
Dinner Rolls-6Pc--->咸餐包六入
Vietnamese Sandwich--->越式三明治
D Italiano Whole Wheat Bread--->全麦方饱
Ditaliano Thick Slice--->DITALIANO厚片吐司面包
Raisin Scone--->提子英式松饼
Cheese Scone--->芝士英式松饼
Coconut Walnut Pandan Bread--->香兰椰丝核桃方包
Tuna Sandwich--->吞拿三明治
Philippine Mini Buns--->黄金小石头
Coffee Crispy Crust Danish--->咖啡长菠萝奶酥
Wonder White Texas--->德州白方包
Ch Flax&Quinoa Bread--->CH亚麻籽藜麦包
Bbq Duck - Half--->烧鸭-半只
Marinated Duck (Half)--->卤水鸭(半只)
Mini Pan Fried Pork Bun--->迷你生煎包
Fried Brown Rice W/ Seafood& Garlic--->糙米蒜香海皇炒饭
Golden Crispy Fried Fish Fillet--->香酥鱼扒
Chiu Chow Fish Ball--->潮州鱼丸
Garlic (Peeled)--->蒜仁
Black Bean Chichen Feet--->豉汁凤爪
T&T Organic Red Bean--->T&T 有机红豆
CHUANNAN SPICY DRIED RADISH--->川南麻辣萝卜乾
HADAY SUPERIOR LIGHT SOY SAUCE--->海天鲜味生抽
SUNRIGHT FORTIFIED ALL PURPOSE FLOUR--->日正中筋面粉
HEYE DRIED WOLFBERRY--->禾煜枸杞王
Heyu Dried Longan--->禾煜桂圆乾
UPOC WHITE SEASAME SAUCE--->统一生机芝麻酱
PHIDELIA PREMIUM WALNUT HALVES--->PHIDELIA核桃仁半
Soo Soft Shredded Pork (Jar)--->猪肉松(大罐装)
Soo Extra Spicy Five Spices Beef Jerky--->狮牌特辣五香牛肉乾
Soo Hot Fruit Flavored Beef Jerky--->狮牌辣果汁牛肉乾
Kimlan Soy Sauce-Less Salt--->金兰薄盐酱油
Purcotton Multifunctional Soft--->全棉时代日用棉柔巾
Juliang Organic Fresh Goji Puree--->巨量有机枸杞原浆
Sante Eye Drops--->参天睡前眼药水
On Kee Brown Abalone 10Pc--->安记红烧鲍10头
NISSIN ROAST BEEF 5P--->出前一丁紅燒牛肉 5包
Yjx Fried Dace With Salted Black Bean--->鱼家香豆豉鲮鱼三罐装
Kokuho Rose Rice--->红国宝米
YAMASA KONBU TSUYU SOUP BASE--->山字昆布多用途汁
Wu-Mu Medium Dried Noodle--->五木山东拉面中条
Nongshim Beef Cup Noodle--->农心牛肉杯面
GLICO MEDIUM HOT CURRY--->固力果中辣咖哩
Assorted Bean Curd -S--->斋卤味拼盘-小
Vietnamese Roast Sausage--->越式烤香肠
Unagi Onigiri--->鳗鱼饭团
Spicy Salmon Onigiri--->香辣三文鱼饭团
Salmon Sushi Roll (L)--->三文卷 (大)
Cucumber Sushi Roll (L)--->青瓜卷 (大)
Steam Pork Beancurd Rolls (Cold)--->鲜竹卷 (冷)
5.2In Pink Salt Brown Sugar Cheesecake--->岩盐黑糖芝士蛋糕
Bbq Lamb Ribs--->烧羊排骨
Hui Feng Old-Time Flav. Braised Dried Tofu--->惠丰古味卤香豆干
Sdc Shallot Noodle--->沈大成上海葱油拌面
Ygf Ice Bayberry Fruit Drink--->羿宫坊冰冻杨梅汁
Futomaki Sushi Set--->花海苔寿司
Salted Egg Yolk Puff Bread--->金沙奶黄泡芙面包
Kung Fu Duck Spicy Sweet Duck Wings--->精武甜辣鸭翅
Dxc Original Cookies--->稻香村冷冻贝壳酥原
Dxc Rose Rice Ball--->稻香村玫瑰汤圆
Wing Lee Tube Soft Tofu--->永兴包仔条嫩豆腐
T&T Taro Scone--->T&T芋头烤饼
Deluxe Kikumori Sushi Set--->特上菊盛杂锦寿司
Vietnamese Ham--->越式火腿
Avocado Sushi Roll--->牛油果卷
Dried Shredded Pork Onigiri--->肉松饭团
Red Samba Papaya--->红肉SAMBA木瓜
ZUMIAO YELLO ROCK SUGAR--->祖庙黄冰糖
SHIRAKIKU DRIED MUSHROOM--->白菊印椎茸
Pan-Tang Water Chestnuts Flour--->泮塘纯正马蹄粉
Kingsford Corn Starch--->Kingsford鹰粟粉
GOLDEN COINS ALMOND AGAR MIX--->金钱杏仁豆腐粉
GOLDEN COINS COCONUT DESSERT MIX--->金钱椰子布丁粉
KNOX UNFLAVOURED GELATINE--->乐士无味鱼胶粉
COSINE JUMBO TAPIOCA--->康祥黑珍珠波霸
KNORR BEEF BOUILLON CUBE--->家乐牛精粒
Lee Kum Kee Hoisin Sauce--->李锦记海鲜酱
Gold Kili 3 In 1 Instant Cereal--->金麒麟即溶麦片
Nissin Chicken Noodle--->日本日清小鸡拉面
SERENA EGG ROLLS--->喜年来蛋卷
MIZKAN SUSHI VINEGAR--->味滋康寿司醋
KNIFE PURE PEANUT OIL--->刀唛纯正花生油
MAGGI SEASONING SAUCE (RED)--->美极红盖鲜酱油
Maggi Seasoning Sauce(Red)--->美极鲜酱油(红盖)
LEE KUM KEE KUM CHUN OYSTER FLAVOURED SAUCE--->李锦记锦珍蚝油
UFC BANANA SAUCE--->UFC菲式香蕉酱
Lee Kum Kee Chicken Marinade--->李锦记豉油鸡汁
Bull-Head Barbecue Sauce-L--->牛头牌沙茶酱大
BULL HEAD BARBECUE SAUCE--->牛头牌沙茶酱
Osmanthus Fermented Rice Egg White Tart-6Pcs--->桂花酒酿蛋白塔-6件
Sweet Milk Egg White Tart-1 Pc--->甜奶蛋白塔-1件
Brussel Sprout--->龙眼包心菜
Tong Sheng Original Chinese Yam--->同盛山药块
Beef Ribs W/Special Sauce-Cold--->秘制红烧牛排骨(冷)
Lamb Belly With Beancurd-Cold--->枝竹羊腩(冷)
Sun On Japanese Ramen--->新安日式拉面
Four Treasure Beancurd--->四喜烤芙
Korean Cabbage Kimchi--->韩国泡菜
Fresh Sea Bass--->新鲜海青斑
Sanquan Sweetened Bean Paste Bun--->三全味豆沙包
Asian Legend Pork&Cabbage Dumplings--->味香村鲜肉白菜饺
Beef Brisket W/Daikon--->萝卜牛腩-大
Salmon Sashimi Tray--->三文鱼刺身派对盘
Foong Black Pepper Chicken Rice--->丰师傅黑椒鸡饭
Walnut Almond Mix Nuts Tart-6 Pcs--->核桃杏仁坚果塔-6 Pcs
Seasoned Scallop Lips--->中华乾贝唇
Beef Short Ribs--->牛仔骨
SIWIN ASIAN STYLE BBQ PORK SAUSAGE--->喜之味台湾烤肠
Haagen-Dazs Ice Cream-Coffee--->HD咖啡雪糕
I-Mei Pearl Milk Tea Ice Cream Bar--->义美珍珠奶茶冰棒
SUN NOODLE SHOYU RAMEN--->一生酱油拉面
Iogo Raspberry Nano Drinkable--->IOGO山莓纳米饮用
SANQUAN BLACK SESAME B&W GLUTINOUS RICE BALLS--->三全黑糯芝麻汤圆
OTAFUKU OKONOMIYAKI PANCAKE SAUCE--->多福日式大阪烧酱
MAMA SITAS BBQ MARINADE--->MAMA SITAS烧烤酱
HUY FONG SRIRACHA CHILI SAUCE--->汇丰是拉差辣酱
SOO WILD PACIFIC SALMON JERKY--->狮牌野生三文鱼乾
Aroy-D Coconut Milk--->阿罗地椰奶
JAPAN STYLE TEA CUP--->日本茶杯
NIN JIOM ORIGINAL FLAVOUR HERBAL CANDY--->念慈庵原味枇杷喉糖
YUEN KIT LAM HERBAL TEA--->香港源吉林甘和茶
Vita Lychee Juice--->维他荔枝汁
GOLDEN BONBON ALMOND NOUGAT SOFT CANDY--->加宝软鸟结糖
LEE KUM KEE CHICKEN BOUILLON POWDER--->李锦记鲜味鸡粉
JIAFULI ROASTED & SPICED FLAVOUR PEANUT--->嘉福利五香花生
DINGS FOOD WHITE PEPPER POWDER--->真好家白胡椒粉
AROY-D CANNED QUAIL EGG IN WATER--->阿罗地鹌鹑蛋
Nongshim Hot & Spicy Shrimp Flavoured Crackers--->农心辣味虾条
Lee Kum Kee Minced Garlic--->李锦记蒜蓉
GULONG SPICY SARDINES--->古龙香辣沙丁鱼
SHIRAKIKU ASSORTED HOT RICE CRACKER--->白菊印辣综合米果
Donghu Shanxi Superior Mature Vinegar--->东湖山西老陈醋
TUNG-I ROASTED BEEF SUPER BOWL NOODLE--->来一桶红烧牛肉面
Bin-Bin Seaweed Rice Cracker--->宾宾海苔米果
Calbee Bbq Flavour Grill A Corn--->卡乐B BBQ粟一烧
WANGZHIHE SPECIAL COOKING WINE--->王致和特制料酒
WANGZHIHE ROSE FERMENTED BEAN CURD--->王致和玫瑰腐乳
Hons Roasted Sesame Dessert--->汉记即食芝麻糊
Black Pepper Pork Chop Bento Box--->黑椒猪扒便当
Beef Short Ribs Don--->韩式牛仔骨饭
Fried Peanuts--->生炒花生
Bbq Pork Bento Box--->蜜汁叉烧便当
Spicy Gold Needle Fish--->辣味金针鱼
Light Cheese Cake--->轻乳酪蛋糕
Egg Salad Sandwich With Ham--->鸡蛋白汁火腿三明治
Malay Sweet Steamed Cake--->马拉糕-原味
English Cucumber--->无籽青瓜
LOTTE VANILA DAIFUKU MOCHI--->乐天香草雪米粢
NATUREGG OMEGA 3 EGGS(LARGE)--->NE奥米加3鸡蛋-大
TS FZ RED SAUSAGE--->大新五香赤肉红肠
BURNBRAE SUPER BONEE BROWN--->黄鸡蛋-特大
10Lb Pei Yukon Gold--->10磅装育空马铃薯
TEN TEN PORK BUN--->天天鲜肉包
CRO QUAIL QUAIL EGGS--->鹌鹑蛋
PAK FOK FRIED TOFU--->百福豆泡
YANG PORK AND LEEK DUMPLING--->杨师傅猪肉韭菜水饺
BURNBRAE FARMS LARGE ORGANIC BROWN--->BF有机大黄蛋
OTASTY VEGETABLE PORK POTSTICKERS--->全美猪肉锅贴(大)
Organic Black Oyster Mushroom--->有机黑色蚝菇
OWL PORK BONE & POTATO SOUP--->猫头鹰土豆猪骨汤
NEILSON NLS 4L HOMO MILK - BAG--->NEILSON全脂鲜奶
WANGZHIHE RED CHILLI FERMENTED BEAN CURD--->王致和红辣腐乳
PALM LIVER SPEAD--->牛肝酱
KHONG GUAN SULTANA BISCUIT--->康元提子饼
HUNG FOOK TONG CANTON LORE-PEA VINE DRINK--->鸿福堂鸡骨草
Lee Kum Kee Mushroom Flavoured Dark Soy Sauce--->李锦记草菇老抽
FOUR SEASONS ORCHIDS KELP BUD--->四季彩嫩海带芽
Tong Yeng Roast Eel--->同荣特选烧鳗
FERRERO ROCHER TRIPACK--->金莎巧克力
Prima Taste Singapore Curry--->百胜厨新加坡咖哩
Soo Crisp Shredded Dried Pork Floss Bag--->狮牌袋装猪肉酥
NIN JIOM TANGERINE LEMON FLAVOUR HERBAL CANDY--->念慈庵金桔润喉糖
Haday Golden Label Superior Light Soy Sauce--->海天金标生抽王
Ocean Star Sea Cucumber--->OCEAN STAR圆筒海参
MAMA INST NOODLE-PORK--->妈妈肉碎面
YAMASA SASHIMI SHOYU--->山字日本鱼生鼓油
KIKKOMAN TERIYAKI BASTE&GLAZE--->万字烧烤酱
HF SAMBAL OELEK FRESH CHILI PAS--->汇丰辣椒酱 S/O
Brands Essence Of Chicken Gift Set--->白兰氏鸡精礼品装
SUNITY COCONUT HERBAL JELLY--->生和堂椰粒龟苓膏
LKK PANDA GRN LABEL OYSTER FLV. SAUCE--->李锦记熊猫绿色新装蚝
LEE KUM KEE SOY BEAN SAUCE 240g--->李锦记黄豆酱240g
Biore Body Wash-Orange Blossom--->碧柔抗菌光泽沐浴露
Canavida Fungus Autumn--->大山行秋木耳
Dr Wonjin Cica Dressing Solution--->原辰积雪草舒缓面膜
T&T Frozen Basa Fillet--->T&T急冻龙利鱼柳
SUN ON ORGANIC WAXY CORN--->新安冷冻有机玉米
Grand Maple Fz Cooked Shrimp H/O 21/25--->枫华冻基围虾21
Top Chef Frozen Raw Abalone Meat--->顶厨急冻小鲍鱼肉
NP ORIGINAL MILK ICE BAR--->东北大板原味奶冰棒
TENTEN PORK EGG FUNGUS& CHINESE CABBA--->天天白菜三鲜饺
TENTEN PORK & GREEN ONION DUMPLING--->天天鲜肉香葱水饺
CHINAMAID SOYBEAN ROLL--->荃美火锅黄金卷
Haagen Dazs Matcha Ice Cream--->HD抹茶雪糕
Prince Edward Island Beef Slice--->冰岛雪花牛肉片
T&T Taiwan Style Sausage Original--->T&T台式香肠(原味)
Handmade Juicy Pork Buns Raw--->手工小笼汤包生
Garlic--->蒜头
Green Leaf Lettuce--->绿叶生菜
Mini Seedless Watermelon--->迷你无籽西瓜
Beech Mushroom--->柳姬菇
Synear Shrimp&Mushroom Dumpling--->思念金牌虾三鲜水饺
Sk Imitation Crab Stick--->白菊印高级蟹柳
Otasty Veg/Pork Dumpling--->全美猪肉熟水饺
Mipopo Femented Glutinous Rice--->米婆婆甜香酒酿大
T&T Frozen Sliced Noodle--->T&T 刀削面
T&T Chicken & Corn Dumplings--->T&T玉米鸡肉水饺
T&T Fish Balls--->T&T小白鱼丸
Kao Bubble Color Smokey Brown--->花王泡泡染发-烟熏棕
De Zhuang Spicy Pot Base--->德庄麻辣香锅调料
Zdl Preserved Sour Rakkyo--->真的老甜酸藠头
Juliang Hetian Red Dates--->巨量和田大枣
Unico Diced Tomatoes--->原力高番茄-切
Italpasta Elbows Macaroni--->IP意大利通心粉
Italpasta Rotini--->IP意大利面
Camp. Classic Chicken Noodle Soup--->金宝经典鸡汤面
Rice Sticks 10Mm--->花牌河粉10MM
Rice Sticks (Small-3Mm)--->如意牌炒河粉
JEAN FU ROASTED PREPARED SHREDDED SQUID--->珍福珍好碳烤鱿鱼丝
JEAN FU ROASTED PREPARED ROLLED SQUID--->珍福珍好碳烤鱿鱼片
KRACIE COLLAGEN FRAGRANCE CANDY--->葵缇亚玫瑰香体糖
HAOHAO FREEZE DRIED DURIAN--->HAOHAO冻乾榴莲乾
Great Mountain Extra Large Short Ginseng--->大山行特长枝花旗蔘
FUJIYA PEACH DRINK--->不二家水蜜桃饮料
Great Mountain Ginseng Slices Gift Box--->大山行花旗蔘片礼盒
Haitai Original Cracker--->海太加钙营养饼乾
Panasonic Ionic Facial Steamer Ehsa31--->松下纳米离子蒸面机
SOO SPICY SZECHUAN STYLE BEEF JERK--->狮牌川辣牛肉乾
Soo Sweet Grilled Beef Jerky--->狮牌甜味牛肉乾
Xinyuanzhai Plum Drink--->信远斋桂花酸梅汤
Synear Pork & Mushroom Dumplings--->思念猪肉香菇灌汤水饺
T&T Rice Cake Stick--->T&T年糕条
Wild Hairtail Sabre Segment--->东海野生海捕带鱼段
New Zealand Organic Greenshell Mussel--->纽西兰有机青口
Organic Chicken Drumstick--->特选有机小鸡腿
BURNBRAE FAR NATURES BEST (VITAPLUS)--->天然维生素健康蛋
T&T BLACK SESAME ICE CREAM--->T&T黑芝麻冰淇淋
Korean Golden Oyster--->单冻韩国蚝肉
Top Chef Whole Cooked Crawfish--->珍珠小龙虾-熟
Ocean Jewel White Shrimp 90/130--->Ocean Jewel去肠虾仁 90/130
Grand Maple Fz. White Shrimp H/L 26/30--->枫华去头白虾26
Organic Bt Shrimp Ring 31/40--->有机老虎虾圈31
Clear Ocean Fz Cooked Scallops Roe On--->CO急冻熟带子- 带膏
3 Fish Fz. Mackerel Fillet--->三鱼急冻马鲛鱼柳
Taro Cake Supreme--->顶级芋头糕(冷)
Ferma Mixed Vegetable--->FERMA杂菜
Yo Black Bean Milk--->贤安黑豆浆甜
Brandt S. Turkey Thigh With Bone--->烟火鸡上腿-有骨
OASIS NO PULP PREMIUM ORANGE JUICE--->OASIS 无果粒橙汁
Chuan Ho Mini Green Onion Pancake--->禾圃原葱仔饼
SAN SUI EXTRA FIRM TOFU--->SAN SUI EXTRA FIRM TOFU
SAN SUI FIRM TOFU--->SAN SUI FIRM TOFU
NISSIN RAMEN MISO ISU(MISO)--->NISSIN RAMEN MISO ISU(MISO)
SHISEIDO TSUBAKI VOLUME TOUCH CONDITIONER--->资生堂思波绮上质丰盈润发乳
Shiseido Tsubaki Damage Care Conditioner--->资生堂思波绮极致修护润发乳
Loacker Rasberry Yogurt Quadratini--->莱家红莓乳酸威化
T&T DRIED SNOW FUNGUS--->T&T 雪耳
ZOJIRUSHI IH RICE COOKER 5.5 CUPS HCC10--->象印5.5杯IH电饭锅
ZOJIRUSHI IH 10 CUPS RICE COOKER 10 CUPS--->象印10杯IH电饭锅
Snp Birds Nest Aqua Ampoule Mask--->SNP 燕窝安瓿面膜
FULINMEN PANJIN PREMIUM RICE--->福临门盘锦东北米
Wei-Long Kiss Burn Spicy Chicken Flavour Gluten--->卫龙麦辣鸡亲嘴烧
WEI-LONG HOT & SPICY KONJAC SNACK--->卫龙香辣魔芋爽
Laoganma Chili In Soybean Oil--->老干妈风味油辣椒
Shiseido Fino Premium Touch Hair Mask--->FINO高效渗透发膜
T&T Roasted Grape Seed Oil Seaweed Snack--->T&T 葡萄籽油海苔
CARNATION EVAPORATED MILK--->三花淡奶
Yamamoto Barley Grass 100%--->山本汉方大麦若叶
Yaxiya Gutian Tremella--->亚西雅古田银耳
Kracie Hadabisei 3D Whitening Mask--->葵缇亚肌美精3D美白面膜
T&T Organic Black Bean--->T&T 有机黑豆
T&T BEECH WOOD TURNER--->T&T 榉木饭勺
T&T Bamboo Cutting Board--->T&T竹工艺砧板
SHIMIZU OGURA DORAYAKI--->清水红豆铜锣烧
Bakery Happiness Combo--->幸福组合
Bakery Active Combo--->动力组合
Multi-Grain Bread--->多谷方包
CM FRESH FLAT BEANCURD SHEET--->荃美鲜腐皮
ITOEN ITOEN JASMINE GREEN TEA--->伊藤园茉莉绿茶
TOFU SOFT HINOICHI--->好侍嫩豆腐
SUNRISE PEACH MANGO DESSERT TF--->日昇蜜桃香芒豆腐花
Miso Aka W/O Msg Hanamarru--->信州无味精赤味噌
SHIRAKIKU ORIGINAL RAMUNE DRINK--->白菊原味波子汽水
HINOICHI TOFU REGULAR--->好侍豆腐
Dumpling Wrapper--->海天饺子皮
Hw Fo Shanghai Dumpling Wrappers- Twin--->鸿运上海云吞皮- 孖
K. J. Foods Shrimp & Pork Dumpling--->华洪三鲜饺子
K. J. Foods Fried Pork Bun--->华洪生煎包
HM SALTED DUCK LEGS--->一級腊鸭腿
AN CHING SESAME RICE BALL--->安井黑芝麻汤圆
Hohoho Beef Ball--->好好好牛肉丸
OCEAN FOOD FISH CAKE COMBO-C--->鱼丸/炸鱼丸
Hohoho Fried Shrimp Ball--->好好好爽脆炸虾丸
SYNEAR RICE BALL WITH SESAME--->思念醇香黑芝麻汤圆
Unique Seafood Shrimp Wonton--->唯一海皇鲜虾云吞
H.D. Vanilla & Almonds Mini Bars--->H.D.迷你香草杏仁条
Dried Pork Seaweed Roll--->海苔肉松卷
CALPIS LYCHEE DRINK--->可尔必思荔枝汁
MERILIN NORTH DRIED ALMOND SEED--->美林北杏
Huang Fei Hong Spicy Peanuts--->黄飞红麻辣花生
HUANG FEI HONG PEANUTS WITH CRISP CHILI--->黄飞红香脆椒
YUMMYHI JASMINE FLOWERS PASTRY--->丫咪乐茉莉鲜花饼
T&T SALTINE CRACKER--->T&T 盐味饼乾
Um Milled Roasted Black Sesame Seeds--->UM香煎纯黑芝麻
DAVID ROBERTS ASSORTED MINI FRUIT FILLED CANDY--->D.R.什锦迷你果糖
SUNRIGHT CANDY SUGAR--->日正雪晶冰糖
DMDQ SELECTED PU ERH TEA--->东明大桥珍藏普洱
Top Choice Hawthorn Roll--->华鼎牌山楂卷
Want Want Vegetable Flavour Potato Twists(4Pk)--->旺旺蔬菜味浪味仙组合包4入
WANT WANT STRAWBERRY CRISP ROLL--->旺旺夹心酥卷草莓
ALL PLUS ST. MIXING BOWL--->AP不锈钢搅拌盆
GOLDEN NEST LOGAN SWALLOW NEST BEVERAGE--->金燕窝龙眼燕窝饮
LIGO SARDINE IN HOT CHILI SAUCE--->LIGO辣味沙丁鱼
TONG YENG BRAISED EEL--->同荣红烧鳗(豆豉)
EMF WOOD ROLLING PIN 17.5IN--->{"name": "木柄面粉棒17.5IN"}
SHINHO SPICY SOYBEAN PASTE--->欣和六月香豆瓣酱
LOACKER QUAD CAPPUCCINO WAFER--->莱家布奇诺威化
LEE KUM KEE KOREAN BARBECUE SAUCE 279ML--->李锦记韩国烧烤酱297ML
TORONTO MAPLE CREAM COOKIE--->枫树糖曲奇饼
SHISEIDO WATER IN LIP BALM--->资生堂保湿唇胶
SHJ ASSORTED FRUIT FLAVOUR COCONUT JELLY--->盛香珍果冻椰果桶
Vita Mango Juice Drink--->维他芒果汁
ACTIVIA FIBRE RED FRUITS&CEREALS/PEACH--->ACTIVIA综合优格
Frozen Squid--->急冻火箭鱿鱼
Nestle Drumstick S-Dipped Vanilla--->雀巢脆皮甜筒香草
Y.L.BOILED SALT DUCK EGG--->Y.L.BOILED SALT DUCK EGG
DANACTIVE STRAW/BLUEBERRY--->草莓蓝莓优酪乳
ACTIVIA BLUEBERRY/WTRAW-RHUBARB--->ACTIVIA蓝/草莓优格
Wei Chuan Nara-Shiang Mini Buns--->南翔猪肉小笼汤包
Choripdong Dried Anchovy For Fried--->小鱼干
House Fettuccine Shirataki Noodles--->屋牌豆腐粗面
Hua Yang White Shrimp H/L--->华洋南美去头白虾
LOTTE HOKKAIDO VANILLA BAR--->北海道香草冰棒
Oj Cooked Shrimp Cpto31/40--->OJ 凤尾熟虾31/40
OJ Raw White Shrimp P&D31/40--->OJ 去肠虾仁31/40
ASIAN LEGEND ASIAN STYLE FETTUCCINE--->味香村宽扁面
SANQUAN SCALLION TWISTED BUN--->三全葱油花卷
DELIZIA Mini Green Tea & Red Bean Bao--->迷你抹茶红豆包
NEILSON MICROFILTERED 2% MILK - CTN--->NS过滤2%鲜奶
NEILSON HOMOGENIZED LACTOSE/F MILK - 2L--->NS低乳糖3.25%鲜奶
Pillers Black Forest Ham 1/2--->PILLER黑森林火腿
BUONO GREEN TEA NON DAIRY FZ DESSERT MOC--->绿茶椰奶雪麻糬
GRAND MAPLE FROZEN WHITE SHRIMP H/O 30/40--->枫华有头白虾30
President Choice Bacon--->PC原味培根
Meiji Tsujiri Okoi Matcha Ice Bar--->明治抹茶冰棒
ASIAN LEGEND PEKING SAUCE DRIED NOODLE W--->ASIAN LEGEND PEKING SAUCE DRIED NOODLE W
VITA BLACKCURRANT JUICE DRINK--->维他黑加仑子汁
SAU TAO ALBLONE & CHICKEN RICE VERMICELLI--->寿桃鲍鸡汤河5包
Ujinotsuyu Japanese Roasted Rice Green Tea--->宇治玄米茶
TRIPLE LEAVES EXTRA STRENGTH SLIM TEA--->清秀丽减肥茶加强版
Falcon Condensed Milk--->鹰唛炼奶
TRUNG NGUYEN GOURMET BLEND GROUND COFFEE--->TRUNG NGUYEN原味咖啡粉
Lee Kum Kee All Purpose Marinade--->李锦记瑞士汁
Mazola Corn Oil--->万岁粟米油
Kingo Dried Lotus Seed--->金谷牌莲子
KIMLAN SOY SAUCE--->金兰酱油
KINGO BAMBOO FUNGUS--->金谷牌竹笙
JIAFULI ROASTED & NAM YU BEANCURD FLAVOUR PEANUT--->嘉福利南乳花生
Want Want Senbei Rice Cracker--->旺旺仙贝
GOLD PLUM 17.5% COOKING WINE--->金梅17.5%花雕酒
KINGO MUNG BEAN--->金谷绿豆
KINGO DEHYDRATED CITRUS PEEL--->金谷新会陈皮
Want Want Hot Kid Honey Flavour Cookie Ball--->旺仔蜂蜜小馒头
Gallo Extra Virgin Olive Oil--->GALLO特纯橄榄油
MALTESERS--->麦提沙巧克力
GREENMAX YAM & BLACK RICE CEREAL--->马玉山紫山药黑米仁
YAMASA SUKIYAKI SEASONING BASE--->山字寿喜烧汤汁
Paldo Spicy Noodle With Soy Peptide--->八道御膳火拉面
SUPER Q PALABOK--->SUPER Q米粉
Lotte Greentea Mini Yukimi Daifuku Mochi--->乐天绿茶雪见大福
CYNTHIA PORK BUN--->嘉佳鲜肉大包
Pacific Dried Scallop--->太平青岛元贝
Golden Pillow Danish Bread--->金枕头手撕吐司
Top Chef Blue Cod Fillets- Value Pack--->野生蓝鳕鱼柳家庭装
LOTTE MANGO DAIFUKU MOCHI--->乐天芒果雪米粢
Ocean Jewel Fz. Cooked Shrimp Meat 100/2--->海中宝急冻熟虾仁
SUN ON FROZEN CHESTNUT--->新安冰冻栗仁
WZW FISH BALL WITH MEAT--->丸中王有馅马鲛丸
WZW BEEF BALLS--->丸中王潮式牛肉丸
T&T Red Bean Ice Cream--->T&T红豆冰淇淋
Lemon--->柠檬
Chinese Golden Pear-Box--->中国水晶梨-盒
Seafood Mushroom(Bag)--->海鲜菇(袋)
Champmar Ecuador White Shrimp H/O 40/50--->南美虾皇有头白虾
Amoy Dim Sum Shrimp Dumpling--->淘大点心虾饺
NORTHERNFOOD SHRED TOFU MARIN CHICK BROT--->NORTHERNFOOD SHRED TOFU MARIN CHICK BROT
Chapmans Milk Choco Almond Bars--->卓文杏仁巧克力冰棒
Synear Chive & Egg Vegetable Dumpling--->思念韭菜蛋素水饺
MANNARICH FOOD FISH PASTE--->MANNARICH FOOD FISH PASTE
CHUAN HO GREEN ONION PANCAKE--->CHUAN HO GREEN ONION PANCAKE
Swicy Shepherdspurse Pork Bun--->随喜荠菜鲜肉包
Mixed Fruit Cake--->杂果蛋糕
Black Forest Cake--->黑森林蛋糕
WANGZHIHE REFINED YELLOW COOKING WINE--->王致和烹饪黄酒
GATSBY MOVING RUBBER AIR RISE HAIR WAX--->杰士派弹力柔风发蜡
Gatsby Moving Rubber Wild Shake Hair Wax--->杰士派狂野立体发蜡
Gatsby Moving Rubber Spiky Edge Hair Wax--->杰士派跃动激硬发蜡
Greenmax Matcha Milk Tea--->马玉山抹绿奶茶
NICO SEASONED SEAWEED SNACK--->日本即食紫菜
GLASSLOCK CONTAINER RECTANGULAR--->GL玻璃保鲜盒长
GL GLASS LOCK RECTANGULAR--->GL玻璃保鲜盒
SIX FORTUNE FRESH UDON--->六福鲜乌冬面
T&T Pork Luncheon Meat--->T&T午餐肉
SEMPIO KALBI MARINADE--->泉字韩国排骨酱
TANG JI CRISP SPICY BEAN SNACK--->唐记怪味胡豆
T&T Korean Honey Citron Tea--->T&T蜂蜜柚子茶
KTU YAKI SUSHI NORI (SILVER)--->海达屋寿司海苔(银)
KTU YAKI SUSHI NORI (PURPLE)--->海达屋寿司海苔(紫)
T&T JASMINE GREEN TEA--->T&T 茉莉绿茶
T&T Licorice Roasted Peanuts--->T&T甘草味烤花生
T&T CHINESE STYLE PASTRY WITH RAISIN & SESAME--->T&T 葡萄芝麻琪玛
TAISUN ORIGINAL VEGETARIAN MUSHROOM JERKY--->泰山素牛肉乾原味
SAU TAO SHRIMP NOODLE-THICK--->寿桃特级虾子宽面
Taokaenoi Wasabi Flavour Crispy Seaweed Snack--->小老板芥茉脆紫菜
Taokaenoi Spicy Crispy Seaweed Snack--->小老板辣香脆紫菜
HIME JAPANESE UNON DOODLE--->姬日本乌冬面
Pastry Butter Cake--->酥皮蛋糕
Portuguese Egg Tarts (Cold)--->葡式蛋塔(冷)
SUPERIOR SWEETENED SOYA--->SUPERIOR SWEETENED SOYA
Shaomei Brown Sugar Boba Flavor Ice Bar--->小美黑糖珍奶雪糕
Green Tea Mousse Mochi Cake--->抹茶慕斯白玉卷
Peking Duck + Condiment Combo--->片皮鸭(全只)组合套餐
T&T Pork Mushroom Dumpling--->T&T猪肉香菇灌汤水饺
Unagi Don-Cold--->鳗鱼饭-冷
Snow Pea Leaf(1 Pack/Around 1.5 Lbs)--->豆苗(1 Pack/Around 1.5 Lbs)
Green Beans--->四季豆
Hansung Plain Squid Nugget--->汉盛鱿鱼饼
Shirakiku Poached Egg Onsen Tamago--->白菊印日式温泉蛋
Imuraya Matcha & Mochi Ice Dessert--->井村屋抹茶麻糬冰淇淋
Taiwanese Fried Noodles--->台式炒米粉
Assorted Beancurd - L--->斋卤味拼盘-大
Coconut Chicken Soup--->椰子老鸡汤
Arrow Root Pork Bone Bean Soup--->粉葛赤小豆猪骨汤
Seedless Green Grapes--->无核青提(葡萄)
Frozen Calamari Squid--->急冻盒装小鱿鱼
Sweet & Sour Pork With Fruit--->菠萝咕咾肉
SHJ WASABI GREEN PEAS--->盛香珍芥末青豆
OISHI SPICY PRAWN CRACKERS--->上好佳辣虾条
SHIRAKIKU SEKKA SUSHI RICE--->雪花寿司米
GREEN FARM NON-GMO SOYBEAN--->青农场非基改黄豆
Lotte Koala March Chocolate Biscuit--->乐天朱古力熊仔饼
Lotte Koala March Strawberry Biscuit--->乐天草莓熊仔饼
SUN CHILI RICE CRACKER--->太阳麻辣口味锅巴
JINZAI SPICY & NUMB FLAVOUR THICK BEAN CURD--->劲仔麻辣味厚豆干
JINZAI SPICY & HOT FLAVOUR THICK BEAN CURD--->劲仔香辣味厚豆干
LAOHENGHE COOKING WINE--->老恒和特选料酒
MARUKIN THICK CUT CHEESE BAUM KUCHEN CAKE--->丸金厚切芝士蛋糕
Shu Jiu Xiang Spicy Hotpot Soup Base--->蜀九香清油火锅底料
TUNG FUNG ORGANIC MUNG BEAN--->同丰有机绿豆
CALBEE LESS SUGER FRUIT GRANOLA--->卡乐B减糖豆乳水果燕麦
ORION Q PEDICLE MOCHA CHOCOLATE CAKE--->好丽友摩卡巧克力Q蒂蛋糕
ORION ITALIAN TIRAMISU CAKE--->好丽友提拉米酥派
Samyang Cheese Hot Chicken Fried Ramen--->三养芝士辣鸡拌面
Marukin Baum Kuchen Roll Cake--->丸金年轮蛋糕
MIDEA ELECTRIC RICE COOKER 10 CUPS--->美的10杯电饭锅
DARLIE DOUBLE ACTION TOOTHPASTE--->黑人双重效用牙膏
DARLIE ALL SHINY WHITE TOOTHPASTE--->黑人晶莹洁白牙膏
TAOKAENOI CHICKEN LARB FLAVOUR TEMPURA SEAWEED--->小老板凉拌鸡肉味
DANISA BUTTER COOKIE--->皇冠牛油饼乾
Want Want Assorted Snacks Gift Bag--->旺旺综合大礼包
Sweet & Sour Pork Ribs--->镇江排骨
Bean Curd W/Mushroom-S--->香菇腐皮卷-小
Sdc Steamed Dumplings With Cheese & Egg--->沈大成芝士蛋黄烧卖
Almond Swiss Roll--->杏片瑞士卷
Spicy Crayfish--->香辣小龙虾
Taro Cookies--->香芋酥
Egg Tray Bun--->鸡蛋小餐包
Green Tea Cookie--->绿茶酥
Orange Cream Cheese Bread--->香橙乳酪软式欧包
Bright Dairy White Rabbit Ice Bar--->光明牌大白兔雪糕
Bright Original Momchilovtsi Ice Bar--->光明酸奶冰淇淋原味
Chanthaburi Frozen Durian Pulp Without Seed--->尚莲牌急冻无核榴槤
RWA PORK BNLS HAM INNER SHANK--->全自然猪腱
RWA PORK LOIN CENTRE-CUT--->全自然无骨猪扒
RWA B/L PORK CHOP--->全自然猪肉眼
DUCK BREAST-BONELESS--->鴨胸-無骨
PARTRIDGE--->鹧鸪
LAMB CUBE--->羊肉粒
ANGUS BEEF FLANK MEAT--->安格斯雪花炒肥牛
BLACK TIGER PRAWNS H/L 13/15 (Previous Frozen)--->去头老虎虾13/15
JELLY FISH HEAD SALTED--->鹽漬海蜇頭
KO-LE CABBAGE--->高丽菜
GINGER--->生姜
WANT WANT HOT-KID APPLE BALL CAKE--->旺仔苹果味小馒头
Golden Nest Honey Teriyaki Pork Bites--->金燕窝蜂蜜照烧猪肉块
GABAIYOKA CHARCOAL PEELING MASK--->GABAIYOKA黑炭清洁面膜
PROPOLINSE HONEY MOUTHWASH--->PROPOLINSE蜂胶漱口水
TIC TAC WINTERGREEN--->TIC TAC冰凉糖
EMF PEACE GLASS TEAPOT--->EMF耐热玻璃茶壼
KAO LAURIER FOR HEAVY SANITARY PAD 22.5CM--->花王蕾妮亚素肌纯棉卫生棉22.5CM
KAO LAURIER FOR HEAVY SANITARY PAD 22.5CM--->花王蕾妮亚透气卫生棉22.5CM
KAO LAURIER NO WING SANITARY PAD 17CM--->花王蕾妮亚透气无翼卫生棉17CM
Dariya Sdp The Cream Hair Color #6 Dark Brown--->达雅SALON DE PRO染发剂#6深棕
Papa Recipe Bombee Ginseng Honey Repairing Mask--->春雨红参蜂蜜精油修复舒缓面膜
HADAY SOYBEAN PASTE--->海天黄豆酱
DAN-D-PAK WALNUTS HALVES & PIECES--->丹蒂核桃
GREENMAX FLAXSEED & BLACK SESAME CEREAL--->马玉山亚麻黑芝饮
MORINAGA HI-CHEW SELCTED FRUIT CHEWY CANDY--->森永特选水果软糖
IRIS HEAT PACK--->IRIS暖贴
Albion Skin Conditioner Essential--->ALBION健康化妆水
Sau Tao Egg Rolls--->寿桃鸡蛋卷
SATO HAKUBI WHITE C SOLUTION--->维生素美白肌饮
WANT WANT ORIGINAL FRIED RICE SNACK--->旺旺一定要吃原味
Nongshim Shrimp Flavour Chips--->农心虾片
Great Mountain Spiky Sea Cucumber--->大山行小米刺蔘
TAN TAN LOCK RECTANGULAR WITH DIVIDER 800ML--->TANTAN分隔长方保鲜盒800ML
Jicama--->沙葛
MO QUA--->毛瓜
JUMBO ONIONS--->特大洋葱
Green Bell Pepper--->青椒
Spinach-Loose--->散装波菜
HONEY TANGERINE--->蜜柑
BOK-CHOY(SHORT)--->奶油白菜(矮)
BITTER MELON--->苦瓜
Kirin Fruit--->麒麟果
Red Bean Bread--->红豆方包
Cream Cheese Danish-Mini--->迷你丹麦芝士
Wonder White Bread--->WONDER白吐司面包
Cranberry Scone--->蔓越莓松饼
Raisin Dinner Roll- 6Pcs--->提子餐包- 6件
Coconut Danish--->丹麦椰子包
Golden Guest Mousse Cake Platter--->金盆迎宾慕丝蛋糕组
Supreme Fruit box--->至尊水果礼盒
Ch 14 Grain Bread--->CH 14谷方包(每单限购1份)
Chicken W/Soy Sauce-Half--->豉油鸡-半只
Marinated Duck(Whole)--->卤水鸭(全只)
Spicy Bean Curd--->油淋豆腐
Pork And Fish Roll--->美味鸡卷
Frozen Anago Kabayaki--->急冻蒲烧鳗
Yaa Fang Akemi Popsicle--->雅方冰炫果酸冰棒
JUTSUXIAN SPICY SEAFOOD & SCALLOP SAUCE--->菊之鲜海鲜干贝大
T&T Alloy Spoon--->T&T合金汤勺
Xiaolongkan Hot Pot Soup Base--->小龙坎清油火锅料
T&T Bamboo Steamer Set--->T&T双层竹蒸笼
MARYYA RIPPLE SPONGE RAG--->美丽雅海绵百洁布
SUNRIGHT TAIWAN VERMICELLI (VALUE PACK)--->日正台湾粉丝450G
Dashanhe Hetian Six Stars Red Dates--->大山合和田六星枣
TOP CHOICE ORGANIC COIX SEED--->超卓有机薏米
KINGO RADIX ASTRAGALI--->金榖北耆
Medallion Whole Milk Powder--->加拿大纯成人奶粉
Sunity Original Chinese Herbal Jelly--->生和堂原味龟苓膏
Dashanhe Dried Lotus Seed--->大山合莲子
7D Dried Mangoe Slice--->7D芒果乾
White Conc Vitamin C Whitening Body Wash--->WHITE CONC美白沐浴露
TAMANOHADA LIQUID BODY WASH 003 ROSE--->玉肌沐浴露003玫瑰
FUNYE TRUFFLE OIL APRICOT MUSHROOM CHILI SAUCE--->饭爷松露油杏鲍菇辣酱
DALONGYI TOMATO HOT POT SOUP BASE--->大龙燚番茄火锅底料
Viva Sugar-Free Pine Nuts & Brown Rice Drink--->万岁松子玄米坚果饮
Lotte Koala March Chocolate Banana Biscuit--->乐天巧克力香蕉熊仔饼
Ebara Bbq & Dipping Sauce--->日本烧肉汁酱油味
Wh Somen Noodle--->百合长寿面线
Fish Well Preseved Radish Chopped Chili--->鱼泉香辣风味萝卜
Mama Chicken Bowl Rice Noodles--->妈妈鸡肉月式汤河
5.2In Tiramisu Mkousse Cake--->5.2寸提拉米苏慕丝
Kung Fu Duck Spicy Duck Neck--->精武香辣鸭脖
Kung Fu Duck Spicy Sweet Duck Neck--->精武甜辣鸭脖
Hui Feng Homemade Dried Tofu--->惠丰古早味手打豆干
Hui Feng Hakka Stir-Fried Dried Tofu--->惠丰客家小炒豆干
Long Feng Octopus Fish Ball--->龙凤大阪章鱼丸
Ccmm Sesame Paste Noodle--->厨厨猫咪麻酱拌面
Ccmm Chongqing Style Noodle--->厨厨猫咪麻辣小面
Dynamite Sushi Roll--->天妇罗虾卷
Butterfly Sushi Set--->蝴蝶舞之花
6In Mango Cheese Cake--->6寸芒果芝士蛋糕
Steamed Cake-Original--->原味熊印蒸蛋糕
Pm Pink Cactus Flav. Ice Bar W Wh Bubble--->丸作粉红仙人掌珍珠冰
Stir Fried Spicy Pork - L--->回锅肉-大
Sweet Sticky Corn-2 Pcs--->糯玉米-2个
T&T Layered Green Onion Wheat Pie--->T&T麦香葱千层拉饼
Atlantic Salmon Sashimi--->大西洋三文鱼剌身
Vietnamese Sausage--->越式香肠-蕉叶
Spicy Salmon Roll--->辣三文鱼卷
Red Bean Mochi Egg Tart-6Pcs--->红豆拔丝麻糬蛋塔-6S
Bean Curb--->罗汉斋
Marinated Peanuts--->三色花生
Imitation-Crab Meat & Fins--->蟹肉水翅
Y&Y 3 Minute Chow Mein--->如意三分钟炒面
Hikari Instant Miso Soup--->HIKARI即食味增汤
Unico Elbows--->原力高通心粉
Fish Well Three Gorges Preserved Veg.--->鱼泉三峡榨菜丝
Fish Well Preserved Vegetable-Sliced--->鱼泉三峡榨菜片
Dmdq Tianjin Onserve Delegum--->东明大桥天津冬菜
Fishwell Country Sliced Preserved Vege--->鱼泉农家味榨菜丝
Fishwell Fresh Flaovr Preserved Vegetabl--->鱼泉牌鲜香榨菜
Tamanohada Rose Conditioner 03--->玉肌无硅护发素03玫瑰
Vono Pumpkin Instant Soup--->VONO南瓜浓汤
Ryoe Mild Scalp Conditioner--->吕温和天然护发素
Yyws Tomato Instant Noodle--->曹操饿了番茄碗面
Kao Hot Eye Mask Chrysanthemum--->花王蒸汽眼罩-洋甘菊
Wujiang Red Oil Preserved Vegetable--->乌江瓶装红油榨菜
Taisun Pearl Jobs Tears With Mixed Congee--->泰山珍珠薏仁馔
Little Sheep Chili Pot Spices--->小肥羊麻辣香锅料
Amino Mason Moist Treatment--->AM氨基酸植物护发素
HRBL CLAM HOT AND SOUR NOODLES--->嘿人锡纸花甲粉
ENERGY SPICY VEGE SHIZUMOHE HOT POT--->食族人魔盒鲜蔬火锅
MI TIAO XIONG COCONUT SESAME STICK--->米跳熊椰奶芝麻棒
MI TIAO XIONG EGG YOLK SESAME TICK--->米跳熊蛋黄芝麻棒
ITSUKI KYOTO TONKOTSU RAMEN--->五木京都味噌猪骨面
SIX-F L.K. VERMICELLI-8 PACKS--->六福龙口粉丝(网)
Onion Seasoned Squid Tentacle--->黑椒洋葱鱿鱼须
Seaweed Salad--->中华海带沙律
Portugue Egg Tart-1Pc--->葡式蛋塔-1Pc
Foong Curry Chicken W/ Rice--->丰师傅南洋咖喱饭
Omega Roll--->鲑龙卷
Aburi Salmon Tamago Sushi--->炙烧玉子三文鱼寿司
Korean Fish Paste--->韩式鱼饼
Cello Lettuce--->生菜
TROPICANA PURE ORANGE JUICE-NO PULP--->TROP纯橙汁-无果肉
Sliced Almond Crisps--->杏仁香片
Beidahuang Organic Sweet Corn--->北大荒有机黄甜玉米
FRESH SILKIE CHICKEN--->新鲜竹丝鸡
Grape Tomato--->葡萄蕃茄
Honeydew Melon - Large--->白蜜瓜(大)
Fuji Bread--->富士山面包
Ajisai Assorted Sushi Tray (Tray C)--->函馆什锦 寿司 卷物 拼盘
Signature Staple Food Combo--->招牌包点组合
Kikyo Sashimi & Sushi Tray (Tray D)--->桔梗什锦 刺身 寿司卷物 拼盘
Ready To Cook Combo--->方便易煮组合
Kinmokusei Assorted Sushi Tray (Tray H)--->桂花什锦 拼盘
Bbq Pork - Rtc--->全自然蜜汁叉烧-预腌
Himawari Makimono Tray (Tray A)--->日葵什锦 卷物 拼盘
Angel Food Cake-Lemon--->柠檬天使蛋糕
ITALPASTA SMALL SHELLS PASTA--->IP贝壳意大利面
MORINAGA CHOCO CHIP COOKIE--->森永香浓巧克力曲奇
LOTTE CHOCO FLAVOUR CACAO CHOCOLATE PIE--->乐天可可巧克力派
Wgdc Pickles Potato Noodle--->五谷道场泡菜土豆拉面
Wugudaochang Spicy Beef Instant Noodle--->五谷道场香辣牛肉面
Wgdc Inst Nodle- Spicy Black Bean--->五谷道场豉辣排面
DONGWON TUNA CONGEE--->东远金枪鱼粥
DS&H AGARICUS BLAZEI--->大山合姬松茸
SAN YUANTANG MUNG BEANS--->三元堂绿豆
NONGSHIM NEOGURI MILD NOODLE--->农心浣熊微辣海鲜面
KENKO MISO GINGER SAUCE--->KENKO姜味味增沙拉
FULINMEN STICKYI RICE--->福临门糯米
HAGOROMO MISO MACKEREL--->羽衣味增鲭鱼
JULIANG GANODERMA--->巨量精选灵芝片
CHEN KE MING RAMEN--->陈克明拉面
SATE-TRIEU CHAU SAUCE--->珀宽潮洲沙茶酱
PORKWAN CRAB PASTE W/BEAN OIL--->珀宽蟹膏
PORKWAN SHRIMP PASTE W/BEAN OIL--->珀宽虾膏
ROBIN HOOD FLOUR ALL PURPOSE--->罗宾汉多用途面粉
SIX-F SZECHUAN PRSV BEANCURD-HOT--->四川麻油辣腐乳
MASTRO EXTRA VIRGIN OLIVE OIL--->玛士路特纯橄榄油
Fair Brand Scented Rice--->阿姐 靓米
GREENMAX YAM & MULTI GRAINS--->马玉山山药五谷米
LEE TOM YUM PASTE--->李牌冬阴公汤酱
Iogo Strawberry/Pineapple/Cherry Zip--->IOGO草莓凤梨优格条
Korean Marinated Beef Ribs-Rtc--->韩式牛仔骨-预腌
Rabenda Assorted Sushi Tray (Tray G)--->今治什锦 刺身 寿司 卷物 拼盘
Bbq Pork Bun--->叉烧饱
Kosumosu Assorted Sushi Tray (Tray I)--->秋樱什锦 拼盘
Salted Peanut--->盐炒花生
Suiren Vegetarian Sushi Tray (Tray J)--->到墅 什锦拼盘
Wing Hing Sweetened Soy--->永兴香浓甜豆浆
Frozen Bay Scallops 80/120--->急冻带子80/120
Wing Hing Unsweetened Soy--->永兴香浓纯豆浆
Shobu Assorted Sushi Tray (Tray E)--->浦安什锦 寿司 卷物 拼盘
Asagao Assorted Sushi Tray (Tray B)--->朝颜什锦 寿司 卷物拼盘
Prawn Flavoured Crackers--->炸虾片
SUNRISE CHINESE TOFU (4PCS)--->日昇鲜豆腐皇-4件装
Almond Cookies--->迷你杏仁酥
Special Sauce Chicken Leg-Rtc--->酱烧鸡腿-预腌
Sanford Nz Greenshell Mussel--->纽西兰半壳青口
Jiangnanxiaocai Braised Bamboo Shoot--->江南小菜油焖春笋
Heart Black Tiger Shrimp H/O 26/30--->心牌有头老虎虾26/30
Special Sauce Chicken Wing-Rtc--->酱烧鸡翅-预腌
Binggrae Green Tea Ice Sandwich--->冰极绿茶三文治
Fried Pork Intestine with Pepper--->炒大肠-易炒
Ho May Dou Porr Ribs Black Bean Sauce--->HMD豉椒蒸排骨
Choripdong Frozen Fish Cake-Mix--->韩国火锅杂锦鱼饼鱼丸
PORKWAN HOT CRAB PASTE--->珀宽辣蟹膏
BAMBOE INDO INST SPICES CHIC SOUP--->印尼鸡汤调料
KARAN MODERATE PEANUT SALAD DRESS--->中辣花生沙拉酱
OEY PEANUT SAUCE GADO GADO--->印尼花生调料酱
XPL BEAN CURB WITH RICE SAUCE--->江记米酱豆腐乳
GM HEALTHFUL OATS--->青的农场大燕麦
JULIANG MIXED GRAIN RICE--->巨量营养十谷米
FIVE ROSES A/P WHITE FLOUR--->五玫瑰多用面粉
THREE CRABS FISH SAUCE(S)--->三蟹唛越香鱼露
KINGO CORN GRITS--->金谷玉米小渣
NISHIKI HAIGA RICE--->锦字特选胚芽米
VTG QIN ZHOU HUANG MILLET--->山谷贡粮沁州黄米
HUJIHUA PEANUTS OIL--->胡姬花花生油
HRJ SAUTE SPICY CHICKEN SEASONING--->好人家大盘鸡调料
YOUJIA FISH-FLAVORED PORK CONDIMENT--->友加鱼香肉丝调料
President Choice Avocado Oil--->PC纯牛油果油
Hujihua Peanut Oil--->胡姬花特香型花生油
JM PLACEN LANOLIN PURE MASK--->JM胎盘素羊毛脂面膜
KINGBRINE SPICY CRAB MUSHROOM--->金渤辣针菇蟹柳丝
Sgt 75% Alcohol Hand Sanitizer--->SGT75%酒精免洗手液
Haday Tasty Rice Sauce With Mushroom--->海天香菇拌饭酱
Haday Natural Brewed Soy Sauce--->海天零添加酱油
Haday Signature Oyster Sauce--->海天招牌蚝油
Purple Wheat Bread W/ Walnut--->紫麦核桃蔓越莓包
Sichuan Style Fried Pork--->回锅肉-易炒
Danish Toast--->丹麦吐司
MAPLE LEAF ORIGINAL TOP DOGS--->枫叶原味热狗肠
LONG FENG FISH DUMPLING--->龙凤鱼饺
CALPIS STRAWBERRY DRINK--->可尔必思草莓汁
Long Feng Egg Dumpling--->龙凤蛋饺
LONG FENG CUTTLEFISH DUMPLING--->龙凤花枝饺
Shirakiku Strawberry Ramune Drink--->白菊草莓波子汽水
PILLERS ORIGINAL TURKEY KOLBASSA--->PL波兰火鸡肉肠
Fz Raw Shrimp Meat--->去肠虾仁
Great Lake Greenland Halibut Steak--->锺兴龙鳕鱼扒
Black Tiger Shrimp 26/30--->华洋去头老虎虾26/30
Green Leek Onion--->京葱
Onion--->洋葱
Marinated Eggs--->卤水蛋
Iogo Peach Nano Drinkable--->IOGO桃子优格饮
Kumai Japanese Ramen--->熊井日式手打拉面
SHENDAN PRESERVED DUCK EGG--->神丹松花鸭皮蛋
ZHU LAO DA PORK&CELERY DUMPLING--->朱老大汤肉芹菜饺
Hung Wang E-Fu Noodles--->鸿运长寿伊面
CM FRESH BEANCURD STICK--->荃美鲜腐竹
Gdl Steamed Bun With C Spinach--->功德林斋菜包
Unique Wonto Pickled Cabbage Mushroom Po--->唯一雪菜冬菇肉云
ERAWAN RICE STICK-S--->三象沙河粉-幼
JAPAN NOODLE ( 4 PK)--->当当日式乌冬 (4
LKK SPARE RIB SAUCE (L)--->李锦记排骨酱(大)
A+ JJAJANG KUKSOO DRIED NOODLE--->A+炸酱面
JUAN CHENG PIXIAN DOUBAN--->鹃城豆办免剁型
DOLE TROPICAL FRUIT SALAD--->DOLE罐头水果
PORTHOS SARDINES IN TOMATO SAUCE--->老人牌番茄沙丁鱼
LKK SELECTED 5 SPICES MARINADE--->李锦记五香卤水汁
HELLMANN MAYO 1/2 FAT--->康宝低脂美乃滋
LUCKY ME ORIGINAL INSTANT CANTON (6PK)--->幸运原味炒面(6包装)
MEAL OF EMPEROR ABALONE SAUCE--->御本膳鲍鱼汁
KINGO MILLET--->金谷小米
QP SESAME SOY SAUCE DRESSING--->优比芝麻沙拉酱
BARILLA SPAGHETTI--->BARILLA意粉
GOLDEN KING CANNED GRASS JELLY--->金莱香爽滑凉粉
YI FENG STARCH BALLS--->义峰波霸粉圆
Nongshim Champong Noodle Soup--->农心炒码王
Nongshim Spicy Seafood Kalguksu--->农心韩式辣刀削面
T&T HSINCHU RICE STICK--->T&T新竹米粉
BAIJIA SPICY HOT CHONGQING NOODLE 5 PKS--->白家麻辣重庆小面
TARAMI MANGO PEACH JELLY--->达乐美芒果白桃果冻
SUNITY GREEN TEA HERBAL JELLY--->生和堂绿茶龟苓饮
SUNITY OOLONG TEA HERBAL JELLY--->生和堂乌龙茶龟苓饮
Nongshim Airdired Beef Seaweed Noodle--->农心非油炸牛肉海带面
WAHAHA PINEAPPLE NUTRI-EXPRESS--->娃哈哈凤梨牛奶
Sunon Frozen Vegetable Spring Roll (S)--->新安素菜春卷（小）
SARA LEE POUND CAKE--->莎莉蛋糕
Samlip Frozen Noodle--->三立冷冻乌冬
Superior Less Sugar High Fiber Soy Drink--->顶好低糖高纤豆浆
Chicken&Mushroom Dumpling--->味香村鸡肉香菇饺
T&T CHNESE STYLE SPICY PREMIUM PORK SAUSAGE--->T&T 安康猪辣腊肠
Hime Red Bean Ice Cream--->姬红豆雪糕
FA SPICY BEEF SOUP NOODLE--->一路发川辣牛肉汤
Siwin Taiwanese Sausage--->喜之味台湾香肠
1ST CHOICE SOFT TOFU SOUP BASE--->第一选嫩豆腐汤底
T&T TERIYAKI CHICKEN STEAMED BUN--->T&T TERIYAKI CHICKEN STEAMED BUN
SAMYANG HOT CHICKEN GYOZA DUMPLING--->三养辣鸡煎饺
Jaten Lobster Ball--->佳田龙虾球
Delizia Steamed Sandwich Bun--->得易家割包
SAKURA FARMS SALTED PORK BELLY--->安康猪上海咸肉
LSQIE PLAIN BAKED YOGURT MULTIPACK--->LSQIE烤酸奶4杯装
TEN TEN BBQ PORK BUN--->天天叉烧包
TENTEN PORK & CABBAGE DUMPLING--->天天高丽菜肉饺
Watson Salted Egg Yolk--->华生咸鸭蛋黄
T&T CHINESE STYLE PREMIUM PORK SAUSAGE--->T&T 安康猪腊肠
SAN SUI SILKEN TOFU--->山水嫩豆腐
MANIKER GINSENG CHICKEN SOUP--->韩滋补参鸡汤(整鸡)
Vancouver Northern Food Spiced Bean Curd--->丰业五香素鹅
Orion Corn Soup Turtle Chip--->好丽友玉米乌龟饼
Botan Calrose Rice--->牡丹圆米
Pearl River Bridge Superior Light Soy Sauce--->珠江桥金标生抽
Kikkoman Aji Mirin--->万字味醂
Bin-Bin Assorted Rice Cracker--->宾宾综合米果
AROY-D COCONUT MILK FOR DESERT--->阿罗地椰浆甜点用
COF JIANGXI RICE VERMICELLI--->高富江西米粉
Wu-Mu Thin Dried Noodle--->五木山东拉面细条
ROSE RICE PAPER 22CM--->玫瑰米纸22CM
Nissin Cup Noodles - Seafood Flavour--->合味道海鲜杯面
Nissin Cup Ndl-Spicy Seafood--->合味道辣海鲜杯面
Swanson Chicken Broth--->史云生清鸡汤
Y&Y THAI RICE VERMICELLI--->如意牌泰国米粉
Knorr Chicken Broth Powder--->家乐鸡粉
KNORR CHICKEN BROTH OWDER--->家乐牌鸡粉
Billy Bee Sq.Liquid Honey--->BB纯蜂蜜1KG
UNICO VEGETABLE OIL--->原力高菜油
FARMER DRIED & SALTED PEANUTS--->农夫牌咸干花生
HAPI WASABI GREEN PEAS--->HAPI芥末青豆
Haitai Cheese Cracker--->海太芝士营养饼乾
THREE CRABS FISH SAUCE--->正三蟹鱼露
Marukyo Kuri-Iri Dorayaki--->丸京栗子铜锣烧
PAT CHUN BLACK RICE VINEGAR--->八珍黑糯米醋
MANNARICH STICKY RICE DUMPLING--->东江迷你糯米鸡
AMOY SHRIMP SHAOMAI--->淘大点心虾肉烧卖
1ST CHOICE PORK BONE SOUP BASE--->1ST CHOICE PORK BONE SOUP BASE
Hansung Plain Seafood Nugget--->汉盛海鲜饼
LONG FENG TEMPURA-STICK--->龙凤台式甜不辣-条
SIWIN ASIAN GARLIC SAUSAGE--->喜之味哈尔滨红肠
San Sui Multi-Use Tofu--->山水百搭豆腐
1ST CHOICE KIMCHI STEW BASE--->第一选泡菜汤底
Gdl Steamed Bun W/ Mushroom--->功德林香菇菜包
NG FUNG RICE VERMICELLI--->五丰行濑粉
Pearl River Bridge Superior Light Soy Sauce--->珠江桥生抽王
AMOY LIGHT SOY SAUCE--->淘大生晒鲜抽
Ve Wong Kung-Fu Soy Sauce--->味王功夫酱油
Kimlan Premium Light Soy Sauce--->金兰高级生抽
Kimlan Soy Paste--->金兰酱油膏
YAMASA SOY SAUCE--->山字酱油
Lee Kum Kee Fine Shrimp Sauce--->李锦记幼滑虾酱
Lee Kum Kee Seasoned Soy Sauce For Seafood--->李锦记蒸鱼豉油
BULLDOG TONKATSU SAUCE--->虎狗肉扒酱
S&B WASABI PASTE IN TUBE--->S&B日本芥茉酱(管装)
Lee Kum Kee Black Bean Garlic Sauce--->李锦记蒜蓉豆豉酱
TOOTHPICK IN TUB 500S--->筒庄牙签
Lb Maple Maple Syrup In Plastic Jug--->LB MAPLE枫叶糖浆
TONGXIANG PRESERVED PLUM NO PIT--->同享九制梅肉
Loacker Quad Vanilla Wafer--->莱家香草粒威化
PALM CORNED BEEF--->棕榈树碎腌牛肉
Chin Chin Canned Grass Jelly--->亲亲黑凉粉
RITZ SNACKWICHES CRACKERS--->丽斯轻食饼乾
JIAFULI ROASTED & GARLIC FLAVOUR PEANUT--->嘉福利蒜茸花生
Chaokoh Coconut Juice Wth Pulp--->秋菊椰子水
KIMLAN PICKLED CUCUMBER--->金兰脆瓜
HSUFUCHI ASSORTED NUTS CRISP CANDY--->徐福记酥心糖
KIMLAN GLUTEN WITH PEANUT--->金兰花生面筋
Ever Spring Tea Green Tea Powder--->万年春绿茶粉
Greenmax Sesame Cereal--->马玉山黑芝麻糊
Chicken Brand Pickled Sour Mustard--->小鸡酸芥菜
King To Nin Jiom Herbal Sore Throat Syrup--->京都念慈庵枇杷膏
UNIQUE GINSENG TEA BAG--->唯一花旗蔘茶包
YAMAMOTOYAMA YAKI NORI RED HALF--->山本山寿司紫菜
GOLD PLUM SHANXI SUPERIOR MATURE VINEGAR--->金梅山西老陈醋
HENGSHUN CHINKIANG VINEGAR--->恒顺镇江香醋
TUNG-I SHRIMP FISH SUPER BOWL NOODLE--->来一桶鲜虾鱼板面
BIN-BIN SNOW RICE CRACKER--->宾宾雪蜜米果
Bin-Bin Original Rice Cracker--->宾宾原味米果
SOO FRUIT FLAVOURED PORK JERKY--->狮牌果汁猪肉乾
Nongshim Onion Ring--->农心洋葱圈
SUPER Q GOLDEN BIHON CORNSTARCH STICKS--->SUPER Q菲式米粉
WANGZHIHE FERMENTED BEAN CURD--->王致和大块腐乳
Kjeldsens Butter Cookie--->丹麦蓝罐曲奇饼
CLEAR CARTON TAPE 48MMX50M--->胶纸
GARDEN STRAWBERRY LUCKY CANDY--->嘉顿草莓利是糖
White Rabbit Creamy Candy--->大白兔奶糖
Uha High Conc 8.2 Milk Candy--->味觉特浓牛奶糖
Nongshim Honey Twist Snack--->农心卡哩卡哩
PEARL RIVER BRIDGE RICE VINEGAR--->珠江桥米醋
GREENMAX BLACK SESAME POWDER--->马玉山黑芝麻粉
Soo Crisp Shredded Dried Pork Floss Jar--->狮牌罐装猪肉酥
SPAM LUNCHEON MEAT--->SPAM午餐肉
JEAN FU SMOKING PREPARED SHREDDED SQUID--->珍福珍好烟燻鱿鱼丝
KAO MAGICLEAN ROSE BATHROOM CLEANER--->花王玫瑰浴室清洁剂
STAINLESS STEEL FLIP COVER VAC--->不锈钢按盖保温瓶
MEDIHEAL PIGGYMOM SOAKSOAK NOSE CLEAN PACK--->可莱丝猪鼻贴黑头三部曲
T&T BAMBOO CHOPSTICKS--->T&T免洗竹筷
LUX TEMPTING WHISPER BODY WASH--->丽仕浪漫怡香沐浴乳
PACIFIC INTERNATIONAL DRIED OCTOPUS--->太平洋生晒大章鱼
PACIFIC INTERNATIONAL DRIED FISH MAW--->太平洋清水花胶片
Soo Hot Fruit Flavored Pork Jerky--->狮牌辣果汁猪肉乾
EMF IRONWOOD CHOPSTICK 5 PAIRS--->EMF铁木筷5对装
DMDQ DRIED CHRYSANTHEMUM BUDS--->东明大桥胎菊花
DMDQ DRIED ROSE--->东明大桥玫瑰花
DMDQ DRIED HONEYSUCKLE FLOWER--->东明大桥金银花
DMDQ DRIED JASMINE FLOWER--->东明大桥茉莉花
Samyang Hot Chicken Fried Ramen--->三养辣鸡乾拌面
TIGER TACOOK WHITE RICE COOKER 3 CUPS--->虎牌3杯厚釜饭锅白色
T&T SHANDONG STYLE NOODLES--->T&T 山东拉面
THERMOS QUICK OPEN PRW TUMBLER--->膳魔师象牙保温杯
Ryoe Dry Normal Scalp Hair Loss Repairing Set--->吕中干性头皮防脱发护理套装
Soo Hot Fruit Flavoured Beef Jerky--->狮牌辣果汁牛肉乾
HAPI DORAEMON DORAYAKI--->HAPI小叮当铜锣烧
T&T Dried Mini Shiitake Mushroom--->T&T 庆元金钱菇
Dariya Salon De Pro Hair Dye #4 Light Brown--->达雅SALON DE PRO染发#4浅棕
TAI ZHEN XIANG SATSA FLAVOR TOFU SNACK--->太珍香沙茶豆干
Ryoe Dry Hair Ginseng Total Care Reparing Shampoo--->吕乾性发质人参修护防脱洗发水
SHISEIDO SENKA PERFECT BUBBLE BODY WASH--->资生堂泡沫沐浴露
Nissin Spicy Seafood Big Cup Noodles--->合味道辣海鲜杯面
Sigol Roasted & Salted Seaweed Snack--->SIGOL 盐烧海苔
EMF TSA LOCK COMBINATION--->EMF海关数字锁
EMF CARB BAMBOO MORTAR PESTLE--->EMF碳化竹磨盅
VIETCOCO ORGANIC EXTRA VIRGIN COCONUT OIL--->VIETCOCO有机初榨椰子油
OLD TOWN LESS SUGAR 3 IN 1 WHITE COFFEE--->旧街场减糖白咖啡
WEIDUOBAO ORIGINAL MUSHROOM--->维多宝精选香菇
Haidilao Tomato Hot Pot Soup Base--->海底捞番茄火锅底
CHUANNAN COWPEA WITH CHILI OIL--->川南红油豇豆
Shinho Liu Yue Xian Soy Sauce--->欣和六月鲜特级酱油
UNCLE BILL THAI DRIED LONGANS AAA--->标叔泰国1级元肉AAA
Dashanhe Mini Shitake Mushroom--->大山合金钱菇
T&T PATTERNED BAMBOO CHOPSTICKS 5 PAIRS--->T&T清香竹筷5对
T&T Bamboo Chopsticks 10 Pairs--->T&T高级竹筷10对
GLICO POCKY ALMOND CRUSH BISCUIT STICK--->固力果杏仁粒百奇
JANE JANE PREPARED ROLLED SQUID--->珍珍戏院口鱿鱼
T&T Bamboo Rolling Pin--->T&T 竹杆面棍
T&T Peeled Organic Roasted Chestnuts--->T&T有机栗子仁
SOFY HERBAL PANTY LINER--->苏菲贵爱娘中草药卫生垫
Old Town Mocha 3 In 1 White Coffee--->旧街场摩卡白咖啡
WEI-LONG KISS BURN SPICY GLUTEN MIXED PACK--->卫龙亲嘴烧
Unicharm Silcot Soft Cotton Pads--->丝花润泽化妆棉
SAU TAO TAIWAN STYLE SLICED FLAT NOODLE--->寿桃台式刀削面
EVER GROWTH SPICED FLAVOUR SUNFLOWER SEEDS--->香香五香葵瓜子
TEN REN 103 GINSENG OOLONG TEA--->天仁103人蔘乌龙
SUNRIGHT CRYSTAL SUGAR--->日正手工冰糖
JAPAN SUSHI MAT PP--->日本树脂寿司席
T&T Calrose Rice--->T&T 圆米
DMDQ AGED PU ERH TEA--->东明大桥陈年普洱
Want Want Hot-Kid Original Ball Cake--->旺仔小馒头经济包
Golden Nest Red Dates & Goji Bird's Nest Drink--->金燕窝红枣枸杞燕窝饮
Golden Nest Organic Swallow Nest Drink--->金燕窝有机冰糖燕窝饮
Soo Sweet Grilled Pork Jerky--->狮牌甜味猪肉乾
Purcotton Baby Soft Tissue--->全棉时代婴儿纯棉巾
Mizkan Cheese Tomato Soup Base--->味滋康番茄芝士汤底
Luobawang Tomato Rice Noodle--->螺霸王番茄味螺蛳粉
Jm Solution Ceramide Aqua Capsule Mask--->JM SOLUTION强力补水面膜
Jm Solution S.O.S Ampoule Hyaluronic Mask--->JM SOLUTION水光玻尿酸安瓶急救面膜
Sigol Assorted Seaweed Snack Pack--->SIGOL 海苔优惠包
UTENA PURESA COLLAGEN JELLY MASK--->佑天兰骨胶原果冻面膜
UTENA PURESA HYALURONIC ACID JELLY GEL MASK--->佑天兰玻尿酸果冻面膜
NONGFU SPRING GRAPEFRUIT JASMINE TEA--->茶派西柚茉莉花茶
Dao Xiang Cun Sweet Sesame Fried Dough Twist--->稻香村芝麻甜麻花
LARBEE OWL JELLY--->蜡笔小新猫头鹰冻
T&T Bamboo Sushi Mat--->T&T寿司卷帘
LUX SPARKLING BEAUTY BODY WASH--->丽仕焕活冰爽沐浴乳
LUX MYSTERIOUS BODY WASH--->丽仕媚惑幽香沐浴乳
T&T THAI SWEET CHILI SAUCE--->T&T 泰式甜辣酱
Pacific International Sea Cucumber--->太平洋带头海参
NESTLE ORIGINAL PREMIUM WHITE COFFEE--->雀巢原味极品白咖啡
Kumano Horse Oil 2 In 1 Shampoo + Rinse--->熊野马油二合一洗发护发
GILIM HONEY BUTTER MIX NUT--->GILIM 蜂蜜杂果仁
Golden Nest Honey Sriracha Pork Jerky--->金燕窝蜂蜜是拉差猪肉乾
KAO MERRIES BABY DIAPER NEW BORN 90 SHEETS--->花王纸尿布新生儿90片
Little Sheep Mushroom Hot Pot Soup Base--->小肥羊菌菇火锅料
LIPTON JASMINE MILK TEA--->立顿东方茉香奶茶
ON KEE TOPSHELL SLICE IN ABALONE SAUCE--->安记鲍汁海螺片
Nihon-Yakken Lactobacillus & Enzyme Powder--->金的青汁乳酸酵素
LAOJIEKOU CARAMEL FLAVOUR SUNFLOWER SEEDS--->老街口焦糖瓜子
JULIANG ORGANIC BLACK GLUTINOUS RICE--->巨量有机黑糯米
Sagami Original 0.01 5 Pieces--->相模0.01 5片装
Tseng Noodles Hu Sesame Flavor--->曾拌面-胡麻酱香
T&T Xinjiang Ruoqiang Red Dates--->T&T新疆若羌红枣
MEGUMI ONSEN CLEAR MASK--->惠之本舖温泉提亮面膜
Hackers Pickled Vegetables Self-Heating Hot Pot--->蜀客行酸菜自煮火锅
CEDARWOOD HONEY ROYAL JELLY--->CEDARWOOD加拿大皇家蜂蜜
GREAT MOUNTAIN LESS SUGAR GINSENG MILKTEA--->大山行低糖奶茶
Juliang Organic Goji Berry--->巨量有机枸杞
Ferrero Rocher T-24 Gift Box--->金莎朱古力亮金钻礼盒
Lion Foaming Hand Soap Honey Flower--->狮王淡香泡沫洗手液
Sunity Guava Honey Herbal Jelly Pouch--->生和堂石榴龟苓爽
Orihiro Peach Mango Grape Konnyaku Jelly--->立喜乐桃芒葡萄果冻
Cocochi Ag Ultimate Mask Sakura--->AG抗糖面膜樱花限定
Nestle Kitkat Rich Matcha Wafer--->雀巢甘浓抹茶奇巧
Sunity Pear & Honey Herbal Jelly Pouch--->生和堂梨蜜龟苓爽
JINZAI PICKLED PEPPER FLAVOUR THICK BEAN CURD--->劲仔泡椒味厚豆干
CHUANNAN FRIED PEPPER SAUCE--->川南油辣子
TUNG FUNG ORGANIC RED BEAN--->同丰有机红豆
Wang Original Mini Fish Sausage--->皇牌原味迷你鱼肠
ITO EN PEACH TEA--->伊藤园蜜桃红茶
ORIHIRO APPLE & GRAPE FLAVOUR KONYAKU JELLY--->立喜乐苹果葡萄蒟蒻果冻
PAPA RECIPE ROSE GOLD HONEY LUMINOUS MASK--->春雨玫瑰黄金蜂蜜提亮保湿面膜
PRINGLES BBQ POTATO CHIPS--->品格烧烤味薯片
KOPIKO CAFE BLANCA--->KOPIKO速溶白咖啡
TIC TAC ORANGE--->TIC TAC橙味糖
HADALABO GOKUJYUN FOAMING FACIAL WASH--->肌研极润泡沫洗面乳
Ryoe Herbal Hair Dye 5N Natural Brown--->吕植物染发剂5N自然棕
Sunity Red Bean Milk Herbal Jelly Pouch--->生和堂奶红龟苓膏
XIAOTIANE CHONGQING SPICY HOT POT SOUP BASE--->小天鹅重庆老火锅
Dezhuang Spicy Self-Heating Hot Pot--->德庄香辣即食火锅
KOLOKO ORIGINAL GARLIC PEA CRACKERS--->可乐果原味豌豆酥
GREENMAX FLAXSEED & ADALAY CEREAL--->马玉山亚麻薏仁饮
Okamoto Condom 001 Zero One Large--->冈本超薄避孕套大号
MORINAGA HI-CHEW ASSORTED FRUIT CHEWY CANDY--->森永综合水果软糖
SKYFLAKES FAMILIA ASSORTED CRAKER--->空中综合饼乾
MES Hello Bubble Foam Color - Ash Brown (7K)--->爱茉莉美妆仙植物泡沫染发苦亚麻
GREAT MOUNTAIN WILD SEA CUCUMBER--->大山行野生海蔘
GLICO POCKY CHOCOLATE BANANA BISCUIT STICK--->固力果香蕉朱古力百奇
T&T Alloy Rice Scoop--->T&T合金饭勺
T&T Bamboo Chopsticks 12 Pairs--->T&T竹雕刻筷12对
T&T RICE HUSK RICE SCOOP--->T&T稻壳饭勺
TOP CHOICE ORGAINIC MUNG BEAN--->超卓有机绿豆
TOP CHOICE ORGANIC BLACK SESAME--->超卓有机黑芝麻
JULIANG ORGANIC PURLE RICE--->巨量有机血紫米
MOTO MOTO YAMA SEANSONED SEAWEED SNACK--->元本山味付海苔
Want Want Strawberry Macaroon Wafer Roll--->旺旺草莓黑白配
DIAOPAI SOAP 3 PACKS--->雕牌洗衣皂三连包
SNP CHARCOAL MINERAL BLACK MASK--->SNP黑竹炭面膜
ONEROOT ORGANIC RAW HONEY--->ONEROOT有机蜂蜜
Oneroot Canadian Raw Buckwheat Honey--->ONEROOT乔麦蜂蜜
Shiseido Senka Perfect Whip Cleansing Foam--->资生堂洗颜专科洁面乳
DALONGYI MUSHROOM HOT POT SOUP BASE--->大龙燚菌汤火锅底料
Viva Sugar-Free Quinoa & Sesame Drink--->万岁藜麦芝麻坚果饮
KAO LAURIER SANITARY SUPER GUARD SHORTS--->花王蕾妮亚超吸收卫生棉裤
Xiangpiaopiao Milk Tea--->香飘飘牛乳茶
Shiseido Tsubaki New Moist Shampoo--->资生堂思波绮植萃瞬透保湿洗发水
SHISEIDO SUPER MILD FLORAL FRUITY SHAMPOO--->资生堂超柔鲜花芳香洗发水
Bull Head Shallot Sauce--->牛头牌红葱酱
ROYALTY DIGESTIVES COOKIES--->ROYALTY消化饼
MERILIN DRIED LILY FLOWER--->美林金针菜
Shinho Premium Soy Sauce--->欣和六月鲜特级酱油
Hetianyu Dried Red Dates--->和田玉三星级红枣
Lotte Original Milkis Soda Drink--->乐天原味牛奶苏打
DAN-D-PAK ORGANIC ROLLED OATS--->丹蒂有机生麦片
NONGSHIM ASSORTED CUP NOODLES--->农心综合杯面
Health Style Sugar Free Almond Powder--->健康时代无糖杏仁粉
CHUAN LAO HUI HOT BROADBEAN PASTE--->川老汇郫县红油豆
DEL MONTE FIESTA TROPICAL MIXED FRUIT--->地们热带综合水果
Nongshim Beef Bone Spicy Noodle Black--->农心牛骨辣面
Nissin Black Garlic Oil Tonkotsu Noodle--->出前一丁黑蒜面
T&T Milk Biscuit Egg Roll--->T&T 牛奶蛋卷
BIFESTA EYE & LIP MAKE UP REMOVER--->BIFESTA温和即净眼唇卸妆水
Hsus Dried Seaweed--->许氏北海道昆布
LOTTE ORGINAL MILKIS SODA DRINK--->乐天原味牛奶苏打
DANDY ROASTED & SALTED PINENUTS--->DANDY盐焗松子
Dr.Morita Brightening Facial Mask--->森田净白面膜
SOFY OVERNIGHT COTTON SANITARY PADS 35CM--->苏菲超熟睡棉柔卫生棉35CM
Oct Fifth Bakery Mini Walnut Cookie--->十月初五合桃酥
GOLDEN BONBON ASSORTED ALMOND NOUGAT CRUNCHY CANDY--->加宝什锦脆鸟结糖
KIKKOMAN WASABI SAUCE--->万字芥辣酱
Lotte Custard Cream Cake--->乐天蛋黄派
ICHIBIKI ORGANIC PREMIUM SOY SAUCE 800 ML--->日本ICHIBIKI有机酱油
Kingo Calrose Musenmai Rice--->金谷日式免洗米
FU CHE ORIGINAL HARD BOILED QUAIL EGGS--->福记原味鹌鹑蛋
COW BOUNCIA MILK CREA BODY WASH--->牛牌浓密泡泡沐浴露
ROYAL FAMILY PINEAPPLE CAKE--->皇族金钻土凤梨酥
ROYAL FAMILY GREEN TEA MOCHI--->皇族绿茶麻糬
Kracie Hadabisei 3D Moisturizing Mask--->葵缇亚肌美精3D保湿面膜
Hikari Awase Instant Miso Soup--->HIKARI即食味增汤
MASTERKON SNOW PEAR JUICE--->康师傅冰糖雪梨
DMDQ BEANCURD STICK--->东明大桥素食元枝
Haidilao Spicy Pot Sauce--->海底捞麻辣香锅调味料
WEI RONG BRINE BAG--->味荣万用卤味包
YEJIMIIN MILD HERB COTTON SANITARY PAD 28CM--->YEJIMIIN草本棉面卫生棉28CM
WANT WANT ORIGINAL FRIED RICE BALLS--->旺旺原味小小酥
T&T UDON NOODLE--->T&T 乌冬面
Kracie Hadabisei 3D Facial Super Moist Mask--->葵缇亚肌美精3D超浸透面膜
Nissin Miso Instant Noodle 5Pk--->日清味噌拉面王5PK
T&T Organic Sencha Loose Green Tea--->T&T 有机煎茶茶叶
T&T WHOLE YOUNG BABY CORN--->T&T玉米笋(整)
LEADERS VITA BRIGHT SKIN RENEWAL MASK--->丽得姿维他命亮白面膜
SUN KUNG VACUUM LUNCH BOX--->三光温心保温饭壶
TAISUN MIXED CONGEE WITH LOTUS--->泰山莲子八宝粥
KINGO DRIED HELFHEAL--->金榖夏枯草
T&T WASABI ROASTED GREEN PEAS--->T&T 芥末青豆
T&T Organic Roasted Peeled Chestnut--->T&T 有机栗子仁
T&T Organic Mung Bean--->T&T 有机绿豆
Hengshun Zhen Jiang 3Yr Aged Vinegar--->恒顺三年陈香醋
Glico Pretz Tomato Biscuit Stick--->固力果蕃茄百力滋
SUNRIGHT FORTIFIED CAKE FLOUR--->日正低筋面粉
Ryoe Hair Loss Repair Shampoo For Oily Scalp--->吕防脱生发油性头皮洗发水
TAIWAN MICHIU--->台湾米酒19.5含盐
UYINO TSUYU GENMAI-CHA ROASTED RICE TEA--->玄米茶
SHINSYUICHI SPINACH MISO SOUP--->神州一菠菜味噌汤
FRATERNITY FRIED RED ONION--->红葱酥
AROY-D RED CURRY PASTE--->阿罗地红咖喱胶罐
Choillse Big Red Dates--->长思大红枣
WANGZHIHE SALTED COOKING WINE--->王致和精制料酒
AMOY ALL PURPOSE MARINADE--->淘大瑞士汁
Lungkow Vermicelli--->台湾龙口粉丝
SERENA CHINESE YAM EGG ROLLS--->喜年来山药蛋卷
KINDER BUENO MILKY HAZELNUT CHOCOLATE--->健达牛奶榛子巧克力
Wang Korean Beef Bbq Sauce--->皇牌牛肉烤酱
WANG ORIENTAL STYLE NOODLE PASTA--->皇牌韩国素面
Wang Bbq Sauce For Short Rib--->皇牌牛仔骨烤酱
TONGXIANG PRESERVED DRAK PLUM--->同享九制乌梅
XIN QIAO HOT POT LADLE--->线型火锅匙
SHJ LYCHEE FLAVOUR COCONUT JELLY--->盛香珍荔枝果冻
SHJ ASSORTED FRUIT FLAVOUR COCONUT JELLY--->盛香珍果冻椰果
Canaan Honey Lemon Tea--->加南韩国蜜柠茶
SHISEIDO SUPER MILD FRESH GREEN CONDITIONER--->资生堂超柔护发素
Brands Essence Of Chick & Cordyceps--->白兰氏虫草鸡精
OLD TOWN HAZELNUT WHITE COFFEE--->旧街场榛果白咖啡
Ovaltine Orginal Classic Drink--->阿华田原味
Ovaltine Malted Milk Drink--->阿华田牛奶麦精
Ovaltine Malted Chocolate Drink--->阿华田朱古力麦精
Quaker Quick Oats--->桂格快熟麦片
Shiseido Kuyura Relaxing Herbal Body Wash--->资生堂恬静清香清香沐浴露
GRAND MAPLE DRIED PORK FLOSS WITH SESAME & SEAWEED--->枫华海苔芝麻肉松
Zoji Neuro Fuzzy Rice Cooker 5.5 Cups--->象印5.5杯电脑饭锅
Gold Plum Cooking Wine--->金梅厨用花雕酒
TAIWAN 19.5% COOKING WINE--->红标19.5%料理米酒
KINGO DRIED FUNGUS--->金谷牌云耳
KINGO BLACK SESAME--->金谷牌黑芝麻
DMDQ SWEET POTATO SLICE--->东明大桥红薯片
NIN JIOM SUPERMINT FLAVOUR HERBAL CANDY--->念慈庵薄荷枇杷糖
KINGO DRIED PEANUT--->金谷珠豆花生
KINGO DRIED DATES NO SEEDS--->金谷无核鸡心枣
Y&Y GLUTINOUS RICE FLOUR--->如意牌糯米粉
SLICE SEEDLESS PRUNE--->彰化宝岛话梅肉
Koikei Black Sesame Almond Cookie--->钜记黑芝麻杏仁饼
Bigen Speedy Hair Color Brown Black--->美源发彩棕黑
UNIQUE LARGE SHORT GINSENG ROOTS--->唯一粗枝花旗蔘
Loacker Dark Chocolate Wafer--->莱家纯巧克威化粒
Wu-Mu Taiwan Plain Noodle--->五木台湾油面
CALBEE TOMATO FLAVOUR POTATO CHIPS--->卡乐B 蕃茄味薯片
UHA HIGH CONC STRAWBERRY MILK CANDY--->味觉条装特浓草莓牛奶糖
A+ LOW SALT ROASTED & SEASONED SEAWEED SNACK--->韩国A+低盐海苔
WOOD RESIN GINSENG FOOT ADHESIVE DETOX PATCH--->木酢仁蔘排毒消肿贴
COCON MIXED MINI PUDDING WITH NATA DECOCO--->可康综合迷你椰果布丁
LOCK&LOCK GLASS CONTAINERS RECTANGULAR 2L--->L&L 密封玻璃长盒2L
T&T CHINESE STYLE PASTRY WITH MULTIGRAIN--->T&T 杂粮沙琪玛
T&T Chinese Style Pastry With Egg--->T&T 鸡蛋沙琪玛
Nissin Demae Itcho Bowl-Xo Sauce Seafood--->出前一丁海鲜碗面
T&T Roasted Seaweed Snack--->T&T 韩国盐烧海苔
LOACKER QUAD ESPRESSO WAFER--->莱家义式咖啡粒威化
MEAL OF EMPEROR XO SAUCE--->御本膳极品XO酱
Taokaenoi Tom Yum Soup Flavour Crispy Seawed Snack--->小老板冬阴功脆紫菜
Taokaenoi Seafood Flavour Crispy Seaweed Snack--->小老板海鲜脆紫菜
Taokaenoi Tomato Flavour Crispy Seaweed Snack--->小老板蕃茄味紫菜
Chuangs Ginger Brown Sugar Cube--->庄记南姜黑糖块
QIAN PU ORIGINAL SEAWEED--->千浦原味海带牙
NISSIN TONKOTSU RAMEN WITH JAPANESE TAKANA--->出前一丁野菜棒丁面
Xiang Piao Piao Black Sugar Mix Milk Tea--->香飘飘黑糖双拼奶茶
Xiang Piao Piao Matcha Mix Milk Tea--->香飘飘抹茶双拼奶茶
SUNITY PEACH HERBAL JELLY--->生和堂黄桃龟苓膏
MISE EN SCENE TWINKLE BLUE 9B--->爱茉莉闪耀蓝染发剂9B
PAGODA LUNGKOW BEAN THREAD--->塔牌龙口粉丝
LEE KUM KEE SAUCE FOR SPICY GARLIC EGGPLANT--->李锦记鱼香茄子酱
LEE KUM KEE SAUCE FOR TOMATO GALIC PRAWN--->李锦记干烧明虾酱
LAO HU ZI MUSTARD--->老胡子绍兴梅干菜
ORIHIRO PEACH KONJAC JELLY--->立喜乐白桃蒟蒻果冻
ORIHIRO GRAPE CONJAC JELLY--->立喜乐葡萄蒟蒻果冻
ORIHIRO MUSCAT CONJAC JELLY--->香槟葡萄蒟蒻果冻
WEI-LONG KISS-BURN GLUTON--->卫龙亲嘴豆皮
LIAN FENG DRIED BAMBOO SHOOTS--->莲峰天目笋干
Nongshim Spicy Seafood Flavor Stir-Fry Noodle--->农心浣熊海鲜炒面
WEI-LONG HOT&SPICY LOTUS ROOT--->卫龙香辣味卤藕
SUNITY GRAPEFRUIT HERBAL JELLY--->生和堂蜜柚龟苓饮
Xiang Piao Piao Strawberry Milk Tea--->香飘飘草莓奶茶
Xiang Piao Piao Wheat Milk Tea--->香飘飘麦香奶茶
Nongshim Shin Black Instant Noodle--->农心浓汤牛骨辣碗面
Sgt 75% Alcohol Hand Sanitizer--->SGT 75%酒精免洗洗手液
Canavida Organic Goji Berries--->大山行有机枸杞
Ocean Feast Fish Maws--->OCEAN FEAST 野生花胶
Glico Spicy Hotpot Flv Biscuit--->川香麻辣锅味百力滋
Glico Mousse Matcha Cookies--->固力果慕斯抹茶饼干
Nissin Curry Seafood Big Cup Noodle--->合味道咖喱海鲜大杯
Tong Yi Pork Bone Flavor Noodle--->统一日式豚骨碗面
Aroy-D Palms Seed In Syrup (Attap)--->阿罗地糖水亚答
Kikkoman Inst.Spinach Miso Soup--->万字菠菜汤料
Cock Tapioca Pearl (Large)--->鸡牌西米(大）
Camp R&W Cream Of Chicken--->金宝忌廉鸡汤
Kikkoman Shiro Miso Soup--->万字白面豉汤
Aroy-D Yelow Curry Paste--->阿罗地黄咖喱胶罐
Cocon Nata De In Syrup Original--->可康块装椰果 原味
Hikari Miso/Enjuku Wakame Instat 8P--->HIKARI即食海带面豉汤
Hikari Mild Sodium Instant Miso Soup--->HIKARI低盐味增汤
President Choice Organic Sugar--->PC有机白糖
Youjia Green Pepper Oil--->友加藤椒油
Wujiang Chili Oil Preserved Vegetable--->乌江麻辣红油榨菜
Pun Chun Sweet Soy Sauce--->品珍煲仔饭豉油
T&T QINZHOU MILLET--->T&T 沁洲黃小米
Kao Slim Guard Night 40Cm--->花王零触感加长夜用40cm
BOTANIST MOIST TREATMENT--->BOTANIST MOIST TREATMENT
Shinho Organic Soybean Paste--->欣和有机豆瓣酱
Bragg Organic Apple Cider Vinegar--->BRAGG有机苹果醋(大)
Kiki Aromatic Scallion Noodles--->KIKI葱油拌面
Kiki Sichuan Pepper Noodles--->KIKI椒麻拌面
Kao Hot Eye Mask--->花王蒸汽眼罩-无香
Nissin B/Garlic Oil Demae Iccho--->出前一丁黑蒜猪骨碗面
Youjia Chili Powder--->友加辣椒粉
Youjia Chili Powder--->友加辣椒面
Wangzhihe Red Beans Paste-Fine--->王致和红豆沙(细颗粒)
Meiji Vanilla Giant Hello Panda--->明治香草熊猫饼干
Liu Quan Snails Rice Noodle--->柳泉螺蛳粉网红版
JINSHAHE SC DD NOODLE ADDFREE--->JINSHAHE SC DD NOODLE ADDFREE
Jinshahe Shanghai Noodle--->金沙河无添加阳春面
Chung Jung One Soy Bean Paste500g--->清净园韩国黄豆酱
T&T Fried Gluten With Mushroom--->T&T香菇面筋
GLICO TOM YUM KUNG FLAVOUR BISCUIT--->冬阴功味百力滋
SHUN SAVORY PEPPER FLAVOR NOODLE--->顺香春椒麻乾拌面
MI TIAO XIONG ORIGINAL SESAME STICK--->米跳熊原味芝麻棒
ZHONGWANG SCALLION PETITE PATE FRT TWST--->众望葱油咸味麻花
HHC CRAB FLAVOR SNACKS--->嗄嗄叫帝王蟹碳烧
DABAI ORGANIC TRICOLOR QUINOA--->大白有机三色蔾麦
DABAI ORGANIC WHITE QUINOA--->大白有机白色蔾麦
L&G BLACK PEANUT OIL--->狮球唛黑花生油
DS&H FLOWER SHIITAKE MUSHROOM--->大山合茶花菇
DS&H DRIED OYSTER MUSHROOM--->大山合平菇条
WANGZHIHE NON-GMO SOYBEAN PASTE--->WZH非转基因鲜香豆酱
EAGEL COIN CRISPY FRIED DACE--->鹰金钱鲜炸鲮鱼
DANDAN PICKLED FISH SEASONING--->丹丹酸菜鱼调料
HANENCAI COLD BUCKWHEAT NOODLE--->韩恩彩荞麦冷面
FRAGRANT JASMINE RICE--->如意牌香米
RED RICE--->如意牌红米
NISHIKI GEN MAI (BROWN RICE)--->锦字日本玄米
ASIAN HOME GOURMET PAD THAI PAT NOODLES--->佳厨泰国炒面酱
HEINZ WHITE VINEGAR PLASTIC--->白醋
SIX-F PRESERVED HOT BEANCURD--->六福四川麻辣腐乳
GREENMAX FINE MULTI GRAINS--->马玉山五谷米-中
W.J.F. BLACK SOY BEAN--->甘味豆鼓
PORKWAN SHRIMP PASTE--->珀宽咸虾膏
SUKOYAKA GENMAI--->日本健康玄米
MEAL OF EMPEROR ABALONE SCALLOP SAUCE--->御本膳鲍鱼瑶柱汁
PRESIDENT CHOICE ORGANIC OLIVE OIL--->PC有机橄榄油
PRESIDENT CHOICE ORGANICE WHITE QUINOA--->PC有机白藜麦
FUN YE KUNG PAO SAUCE--->饭爷宫保酱汁
FUN YE FISH-FLAVOURED SAUCE--->饭爷鱼香酱汁
YOUJIA TWICE-COOKED PORK CONDIMENT--->友加回锅肉调料
YOUJIA CHONGQING NOODLES CONDIMENT--->友加重庆小面调料
SAN HO CAS TAIWAN RICE--->三好米CAS 奉膳米
CALBEE SNAPEA CRISPS ORIGINAL--->卡乐B原味雪豆片
PALDO RABOKKI NOODLE--->八道炒年糕拉面
SUNITY MATCHA FLAVOUR HERBAL JELLY--->生和堂抹茶龟苓配
HANENCAI SPICY GRILLED COLD NOODLE--->韩恩彩烤冷面火鸡酱味
STERILIZATION WIPES(16PC)--->心相印99.9杀菌湿巾
Sunity Salt Cheese Herbal Jelly--->生和堂海盐芝士烧龟苓
SUNITY CRANBERRY HERBAL JELLY--->生和堂蔓越莓龟苓膏
JUMBO PRAWN COLORED CRACKERS--->珍宝彩色龙虾片
LKK VEG STIR-FRY SAUCE--->李锦记素食蚝油
LEE KUM KEE VEGETARIAN HOISIN SAUCE 436ML--->李锦记素食海鲜酱436ML
LEE KUM KEE SICHUAN STYLE BROAD BEAN SAUCE 350g--->李锦记红油豆瓣酱350g
YOU YOU SPICED DRIED TOFU--->有友卤香豆干
SANLIAN GREEN BEAN LONGKOU VERMICELLI--->三联绿豆龙口粉丝
Haidilao Broth Flavor Hot Pot Seasoning--->海底捞清汤火锅汤料
BEIMEN DRIED BEAN STRING--->北门云南石屏云丝
Great Mountain Japanese Dried Scallop--->大山行日本干贝
Happy Days Goat Milk Powder 1Kg--->加拿大山羊奶粉1KG
T&T Vegetable Oil--->T&T 菜油
Yyws Instant Noodle Turkey Flavour--->曹操饿了即食面火鸡味
Biore Body Wash Rose--->碧柔千叶玫瑰沐浴乳
Soft Mate Premium Nature Dry Tissue 160S--->Soft Mate天然干柔洗脸巾160s
Good Feeling Org Cotton Cover Overnt--->好感觉有机纯棉超吸收卫生裤
Zdl Pickled Cowpea--->真的老泡豇豆
Glico Match Mousse Cookies--->固力果抹茶慕斯百醇
Kao Bubble Color Dark Rose--->花王泡泡染发-乾枯玫瑰
A-Sha Mandarin Natural Noodles 20 Piece--->阿舍中式天然纯面
Jfl Dried Tape Kelf--->嘉福利烘干海带片
Zdl Pickled Ginger--->真的老泡仔姜
Yumei Self-Heating Fish Pickled Soup--->与美酸菜鱼自热锅
Tong Yi Seafood Flavor Noodle--->统一海鲜碗面
Zhangxiaoquan Lingyue Earpick--->张小泉灵悦系列耳勺
Camp Cl.Cream Mushroom Soup--->金宝忌廉蘑菇浓汤
Rice Sticks (Large-10Mm)--->如意牌炒河粉
Kikkoman Hot & Sour Soup--->万字酸辣蛋花汤
Rice Paper 16Cm (Box)--->花牌盒装米纸16CM
Chaokoh Coconut Gel--->樽装椰子膏
Lotus Rice Paper--->莲花牌米纸
Dings Food Salt & White Pepper--->真好家白胡椒盐
Medicinal Analgesic Patch(Din0--->脱苦海膏布
Tung-I Sesame Oil Vermicelli Noodles--->统一补帖麻油鸡面
Merilin Cumin Seed--->美林孜然
Kikkoman Roasted Sesame Sauce N Dressing--->万字芝麻沾酱
Qp Roasted Nuts Dressing--->优比焙煎坚果沙拉酱
Ryoe Deep Cleansing Conditioner--->吕头皮洁净护发素
Wangshouyi Star Anise--->王守义八角
Vono Sweet Corn Instant Soup--->VONO玉米浓汤
Vono Potato Instant Soup--->VONO马铃薯浓汤
Fun Ye Braised Sauce--->饭爷黄焖酱汁
PAMI SPICY DOLAR TSENG NOODLES--->曾拌面香辣豆捞
T&T HUNAN DRIED LILY--->T&T湖南龙牙百合
Vant Cica Centella Mask--->VT积雪草老虎面膜
Youjia Bay Leaf--->友加月桂叶
Youjia 5 Spice Steam Meat Powder--->友加五香蒸肉粉
T&T 3Min Spinach Sliced Noodles--->T&T3分钟菠菜刀削面
T&T Mini White Shitake Mushroom--->T&T童花菇
Chuanqi Spicy Hotpot Seasoning--->川崎麻辣火锅调料
LOT 100 MIXED GUMMY CANDY--->一百分杂果软糖
LIGO SARDINE IN TOMATO SAUCE--->LIGO茄汁沙丁鱼
SIX FOURTUNE BROWN SUGAR--->六福红糖
GRAND MAPLE COOKING WINE--->枫华厨用广东米酒
Lee Kum Kee Sweet Soy Sauce--->李锦记甜酱油
Want Want Mini Fried Rice Cracker--->旺旺烧米屋
Sau Tao Egg Noodles--->寿桃特级全蛋面
SSF DRIED EGG NOODLES--->新顺福全蛋面
COCON LYCHEE PUDDING WITH NATA DECOCO--->可康荔枝椰果布丁
SHJ LYCHEE FLAVOUR COCONUT JELLY--->盛香珍椰果荔枝桶
Bin-Bin Spicy Seaweed Rice Cracker--->宾宾辣海苔米果
Vita Chrysanthemum Tea--->维他菊花茶
Kelloggs Vector Meal Replacement--->家乐氏代餐
OLD TOWN WHITE MILK TEA ORIGINAL--->旧街场三合一白奶茶
NESTLE MILO CHOCOLATE MALT DRINK--->雀巢巧克力麦芽美禄
NESTLE CARNATION THICK CREAM--->雀巢三花忌廉奶
SHISEIDO KUYURA REVITALIZING FLORA BODY WASH--->资生堂欣怡幽香保湿沐浴露
SUN KUNG STAINLESS STEEL VACUUM POT--->三光不锈钢保温饭锅
KINGO GROSVENER SIRAITIA--->金谷牌罗汉果
Kingo Mushroom--->金谷牌茶花菇
KINGO DRIED MUSHROOM - A--->金谷牌花菇
Kingo Dried Lily Bulb--->金谷牌龙牙百合
KINGO DRIED WOLFBERRY--->金谷牌枸杞
KINGO DRIED STAR ANISE--->金谷牌八角
Lotte Choco Pie--->乐天巧克力派
Nongshim Beef Clay Pot Noodle--->农心石锅牛肉面
GRAND MAPLE CHINKIANG VINEGAR--->枫华镇江香醋
KINGO LUNGKOW VERMICELLI--->金谷龙口粉丝
FISH WELL DELICIOUS PRESERVED VEGETABLE--->鱼泉鲜香榨菜
LIUBIJU SEASAME&PEANUT PASTE--->六必居芝麻花生酱
Want Want Shelly Senbei Rice Cracker--->旺旺雪饼
EXCEL POLAR ICE GUM BOTTLE--->益达瓶装极冰无糖口香糖
COCON MIXED PUDDING WITH NATA DECOCO--->可康综合椰果布丁
SUNKUNG MEAL BOX 0.5MLX2--->三光牌饭盒0.5MLX2
Sau Tao Tomato Rice Vermicelli--->寿桃小桥米线蕃茄
Lee Kum Kee Premium Soy Sauce--->李锦记特级鲜味生抽
KIKKOMAN HONTOYO SOUP BASE--->万字四倍浓缩汤汁
Great Mountain Ginseng Tea Bag--->大山行花旗参茶包
GREAT MOUNTAIN GINSENG CANDY--->大山行花旗参糖
LION&GLOBE PEANUT OIL--->狮球唛纯正花生油
Uha Puccho Miracle Soft Candy--->味觉幻彩条装软糖
SHINHO SOYBEAN PASTE--->欣和葱伴侣黄豆酱
MASTERKON HONEY JASMINE TEA--->康师傅茉莉蜜茶
Gatsby Moving Rubber Loose Shuffle Hair Wax--->杰士派松散曲感发蜡
CENTURY TUNA WITH CALAMANSI--->世纪青柠吞拿鱼片
Kingo Gen-Ji-Mai(Brown Rice)--->金谷营养玄滋糙米
TRIPLE LEAVES REGULAR STRENGTH SLIM TEA--->清秀丽减肥茶普通版
MAMA INSTAND NOODLE MEAT FLAVOR--->妈妈肉碎面5包
NESTLE ORGINAL MILO DRINK--->雀巢原味美禄
Kuki Pure Sesame Oil--->九鬼古法纯正麻油
KINGO DRIED DATES--->金榖牌有核红枣
VINAMIT JACKFRUIT CHIPS--->VINAMIT菠萝蜜乾果
T&T Aloe Vera Drink--->T&T芦荟乐
TAISUN SPICY VEGETARIAN MUSHROOM JERKY--->泰山素牛肉乾辣味
G7 VIET 3 IN 1 INSTANT COFFEE--->G7越南三合一咖啡盒
T&T Pineapple Cakes--->T&T凤梨酥
Chuangs Longan & Red Dates Brown Sugar Cube--->庄记桂圆红枣黑糖块
NESCAFE RICH-RICHE CANISTER--->雀巢即冲咖啡罐装
MEI YUAN PRESERVED WHITE SEEDLESS PRUNE--->美元梅好白话梅肉
QIAN PU CRAB MEAT SEAWEED SOUP MIX--->千浦海之野菜蟹玉
Kao Liese Bubble Hair Color Natural Black--->花王泡沫染发天然黑
HIGH CLASS PEANUT OIL--->鲁花压榨一级花生油
Lee Kum Kee Gluten Free Soy Sauce (Mid)--->李锦记无麸酱油中
Kao Hot Eye Mask Rose--->花王蒸汽眼罩玫瑰
Nong Shim Less Sodium Luncheon Meat--->农心低盐午餐肉
GREENMAX BLACK SESAME MILK OATMEAL--->马玉山黑芝牛奶麦
JINZAI SALT BAKED FLAVOUR THICK BEAN CURD--->劲仔盐焗味厚豆干
My Beauty Diary Royal Pearl Radiance Mask--->我的美丽日记皇室珍珠光彩面膜
SHU JIU XIANG SPICY POT SAUCE--->蜀九香麻辣香锅
TUNG FUNG ORGANIC BLACK BEAN--->同丰有机黑豆
Panasonic Thermo Pot Nceg3000-3 L--->松下电热水壶NCEG3000-3升
LESENA MULTI LAYER COTTON PADS--->LESENA多层化妆棉
Dr.Jart Clearing Mask--->DR.JART镇静抗痘面膜
PRINGLES ORIGINAL POTATO CHIPS--->品格原味薯片
Lee Kum Kee Kum Chun Soy Sauce--->李锦记锦珍生抽
GOLDEN NEST HONEY TERIYAKI CHICKEN BITES--->金燕窝照烧鸡肉块
TIC TAC FRESH MINT--->TIC TAC薄荷糖
KOUKISHOKO WEIPA CHINESE SEASONING--->日本味霸调味料
JIN SHAN JIN MEI DATEs WITH WALNUT--->晋善晋美枣夹核桃
T&T Hotpot Sweet Potato Vermicelli--->T&T红薯火锅炖粉
Nissin Black Garlic Ramen--->出前一丁黑蒜棒丁面
LUOBAWANG ORIGINAL LIUZHOU RICE NOODLE--->螺霸王原味螺狮粉
Dr.Jart Porecting Solution--->DR.JART竹炭清洁面膜
Dariya Sdp The Cream Hair Color #4 Light Brown--->达雅SALON DE PRO染发剂#4浅棕
Dariya Sdp The Cream Hair Color #7 Deep Brown--->达雅SALON DE PRO染发剂#7极深棕
XIAOTIANE SPICY HOT POT SOUP BASE--->小天鹅麻辣火锅料
Wang Crab Flavoured Mini Fish Sausage--->皇牌蟹味迷你鱼肠
Miseenscene Hellobubble Foam Color 8Mg Matt Gold--->爱茉莉美妆仙植物泡沫染发亚光金
WAKODO INSTANT ROYAL MILK--->和光堂速溶奶茶
YIJIANGNAN BI LUO CHUN GREEN TEA--->忆江南碧螺春
HUAI LIAN CUMIN & BBQ YAM CHIPS--->怀恋孜然烧烤薄片
CHACHA CARAMEL FLAVOUR SUNFLOWE SEEDS--->洽洽焦糖味瓜子
LULULUN DEEP MOISTURISING FACE MASK--->LULULUN高保湿补水面膜
MIDEA STAINLESS STEEL KETTLE 1.5L--->美的不锈钢电水壶1.5L
Heyu Peach Gum--->禾煜桃胶
TAMANOHADA SHAMPOO 003 ROSE--->玉肌无硅洗发水003玫瑰
Yu Jiang Xiang Fried Dace With Salt Black Bean--->鱼家香豆豉鲮鱼
Jayjun Anti-Dust Whitening Mask--->JAYJUN净化美白面膜
MES Hello Bubble Foam Color - Metallic Ash (7MA)--->爱茉莉美妆仙植物泡沫染发金属灰
MES Hello Bubble Foam Color - Rose Gold (11G)--->爱茉莉美妆仙植物泡沫染发玫瑰金
I M Real Dehydrated Premium Mango Slice--->我是真的芒果干
Tiger Microm Rice Cooker 5.5 Cups--->虎牌5.5杯微电脑电饭锅
Saborino Night Face Mask--->SABORINO晚安面膜
WUJIANG MILD PRESERVED VEGETABLE--->乌江清淡榨菜
JIAFULI LICORICE FLAVOUR PEANUTS--->嘉福利甘草珍珠花生
Samyang Carbo Hot Chicken Fried Ramen--->三养意式起司辣鸡面
T&T Thai Organic Jasmine Rice--->T&T 有机泰国香米
SNUGGLE FABRIC AIR FRESHENER SCENTED BAG--->熊宝贝衣物香氛袋
STAINLESS STEEL VACUUM BOTTLE--->不锈钢真空保温瓶
Haitai Saltine Cracker--->海太盐味营养饼乾
IBUMIE PENANG WHITE CURRY NOODLE--->IBUM槟城白咖哩面
Dmdq Dried Chrysanthemum--->DMDQ黄山贡菊花
DMDQ DRIED HAWTHORN FRUIT--->东明大桥山楂片
T&T Light Coconut Milk--->T&T 淡椰奶
Nongshim Shin Noodle--->农心辛拉面
CLARIIES GUERISSON 9 COMPLEX CREAM--->克莱尔斯马油面霜
Tiger Stainless Steel Thermal Pot 3L--->虎牌电热水瓶3L
TIGER STAINLESS STEEL THERMAL POT 4L--->虎牌电热水瓶4L
T&T Assorted Biscuit Egg Rolls(Milk & Sesame)--->T&T 综合蛋卷礼盒
HAMASAEN MATCHA POWDER--->滨佐粉抹茶粉
T&T Dried Basswood Black Fungus--->T&T 椴木黑木耳
SHINHO HONA ORGANIC SOY SAUCE--->欣和禾然有机酱油
THERMOS FRZ VACUUM INSULATED WATER BOT--->膳魔师冰雪保温杯
LIPTON BRITISH CLASSIC MILK TEA--->立顿英式口味经典奶茶
TAI ZHEN XIANG BLACK PEPPER FLAVOUR TOFU SNACK--->太珍香黑胡椒豆干
SL ROASTED & SEASONED SEAWEED SNACK--->附味紫菜
Heiwa Sesame Oil--->平和芝麻油
Marutai Kurobuta Tonkotsu Noodles--->丸太鹿儿岛豚面
T&T DRIED LIONS MANE MUSHROOM--->T&T 猴头菇
Laoganma Crispy Chili Oil--->老干妈香辣脆
EMF COLANDER--->EMF不锈钢孔筛
Calbee Mixed Fruits Granola--->卡乐B水果燕麦
CHUANNAN BREAKFAST TASTY VEGETABLE--->川南早餐爽口菜
Tanghuang Lotus Seed--->堂皇湘莲红莲子
Shiseido Senka Sweet Floral Bubble Body Wash--->资生堂甜泡沐浴露
T&T XO Sauce--->T&T XO酱
T&T STAINLESS STEEL CHOPSTICKS 5 PAIRS--->T&T 不锈钢筷
T&T Iron Wood Chopsticks 10 Pairs--->T&T 高级铁木筷10对
SOFY HERBAL COTTON SANITARY PAD 33CM--->苏菲贵爱娘中草药纯棉卫生棉33CM
T&T Organic Chestnut Inshell Value Pack--->T&T有机带壳栗子
Nongshim Cuttlefish Snack--->农心鱿鱼片
DASHANHE SHITAKE MUSHROM--->大山合光面菇
DASHANHE BEANCURD STICK--->大山合腐竹
Jayjun Baby Pure Shining Mask--->JAYJUN水光樱花婴儿面膜
YUMMYHI OSMANTHUS FLOWERS PASTRY--->丫咪乐桂花鲜花饼
EVER GROWTH CREAMY FLAVOUR SUNFLOWER SEED--->香香奶油葵瓜子
Yejimein Overnight Contton Sanitary Pad 41Cm--->YEJIMIIN草本超长夜用棉面卫生棉41CM
Lee Kum Kee Seasoned Soy Sauce--->李锦记味极鲜酱油
Kewpie Mayonnaise Salad Dressing--->优比沙拉酱
JINMAILANG PICKLED VEGETABLE & BEEF NOODLE--->今麦郎酸菜牛肉面
GRAND MAPLE DRIED PORK FLOSS--->枫华猪肉松
RICE FA DEN COOKING WINE--->红万寿厨用花雕
CHEWY SWAN DRIED RICE STICK--->超力天鹅星洲炒米
S&B GOLDEN HOT CURRY--->S&B辛辣金装咖哩
AJINOMOTO MONOSODIUM GLUTAMATE UMAMI SEASONING--->味之素调味精粉
ZUMIAO BROWN SUGAR IN PIECES--->祖庙牌冰片糖
SIX FORTUNE WHITE PEPPER POWDER--->六福白胡椒粉
Smuckers Strawberry Jam--->史麦嘉草莓果酱
KIMLAN PICKLED LETTUCE--->金兰小菜心
SIX FORTUNE TAPIOCA STARCH--->六福蕃薯粉
MAMA SITAS SINIGANG TAMARIND SOUP MIX--->MAMA SITAS酸汤粉
LIGO MACKEREL IN WATER--->LIGO清水鲭鱼
KNORR TAMARIND SOUP MIX--->家乐酸子汤粉
SHIRAKIKU DASHI KOMBU DRIED KELP--->白菊印煲汤乾海带
SHINSHUICHI FRIED BEAN CURD MISOSOUP--->神州一炸豆腐味噌汤
Chaokoh Coconut Juice With Jelly--->秋菊椰水加椰肉
Kikkoman Less Sodium Soy Sauce--->万字低盐酱油
Chinamaid Beancurd Stick--->荃美元枝腐竹
CM BEANCURD SHEET--->荃美三边腐竹
LESLIES CLOVER BBQ CORN CHIPS--->LESLIES烧烤味粟米片
Kikkoman Mirin--->万字味淋
Unico Sunflower Oil--->原力高葵花油
Kikkoman Kotterin Mirin--->万字味淋
Lee Kum Kee Chinese Braising Sauce--->李锦记柱侯酱
Shinshuichi Tofu Miso Soup--->神州一豆腐味噌汤
Haitai Almond Cracker--->海太杏仁营养饼乾
ICHIBIKI AJI MIRIN--->味淋
HUY FONG CHILI GARLIC SAUCE--->汇丰蒜蓉辣椒酱
Lb Maple Treat Canadian Maple Syrup--->LB MAPLE枫叶型枫糖浆
WANT WANT SEAWEED SENBEI RICE CRACKER--->旺旺厚烧海苔米果
Pearl River Bridge Superior Light Soy Sauce--->珠江桥金标生抽王
MALING PREMIUM LUNCHEON MEAT--->梅林优质午餐肉
S&B Torokeru Curry Medium Hot--->S&B中辣咖哩
GRAND MAPLE SHAOHSING COOKING WINE--->枫华特级绍兴酒
DINGS FOOD PEPPER POWDER--->真好家黑胡椒粉
DEL MONTE WHOLE KERNEL CORN--->地们玉米粒
KIKKOMAN SUSHI&SASHIMI SOY SAUCE--->万字寿司刺身酱油
GULONG SARDINES WITH SALTED BLACK BEANS--->古龙豆豉沙丁鱼
Lb Maple Treat Maple Syrup--->LB MAPLE枫叶型枫糖浆
COUGH MIXTURE DRINK--->海底椰标止咳露
Brands Birds Nest Rock Sugar--->白兰氏冰糖燕窝
GOLDEN FLOWER CINNAMON STICK--->金花卷玉桂
MASTERKON ICE TEA--->康师傅冰红茶
Hang Heung Egg Roll--->恒香蜂巢鸡蛋卷
HAHN SHYUAN FRIED RICE CRAKCER--->汉正轩咸酥锅粑
CALBEE HOT & SPICY GRILL A CORN--->卡乐B 辣味粟一烧
Nongshim Shrimp Flavoured Crackers--->农心虾条
GARDEN VANILA WAFER--->嘉顿香草威化
Garden Lemon Wafer--->嘉顿柠檬威化
GARDEN STRAWBERRY WAFER--->嘉顿草莓威化
GARDEN CHOCOLATE WAFER--->嘉顿朱克力威化包
Marukyo Tsubuan Dorayaki--->丸京红豆铜锣烧
KHONG GUAN BUTTER COCONUT BISCUIT--->康元椰子饼乾
CHIN-KEE PHOENIX ROLL--->精记凤凰卷
GARDEN ONIONS POP PAN CRACKER--->嘉顿香葱薄饼
HUNG FOOK TONG GINSENG & HONEY DRINK--->鸿福堂花旗蔘蜜中
FAIR BRAND DRIED & SALTED PEANUTS--->阿姐咸干花生
MEGA SARDINES WITH HOT TOMATO SAUCE--->MEGA辣沙丁鱼
AROY-D UHT COCONUT MILK--->阿罗地盒装椰奶
SANGARIA MELON SODA ALUMI CAN--->三家蜜瓜梳打水罐
HEREFORD CORNED BEEF--->希福咸牛肉
JUANCHENG PIXIAN THICK BROAD BEAN--->鹃城牌郫县豆瓣
HIME JAPANESE SOBA NOODLE--->姬日本荞麦面
HELLMANNS REAL MAYO--->康宝美乃滋
MERILIN DRIED CHILLI--->美林辣椒乾
LIHONG FRESH SICHUAN PAPPER OIL--->黎红鲜花椒油
FISH WELL FLAVOR PRES. VEG.--->鱼泉京澳榨菜丝
DEL MONTE FIESTA TROPICAL MIXED FRUIT--->地们杂果
TIEN LI DULIU VINEGAR--->天立独流老醋
DMDQ PRESERVED VEGETABLE--->东明大桥甜梅菜芯
Unico Fushilli--->原力高螺丝粉
TAI SUN RED BEAN SOUP W BLK GLUTIN RIC--->泰山紫米红豆汤
CHUANNAN ASSORTED PICKLES WITH DAY-LILY--->川南黄花什锦
Haidilao Mushroom Hotpot Seasoning--->海底捞菌汤火锅汤
Tai Sun Original Red Bean And Milk Soup--->泰山原味牛奶红豆汤
Nong Shim Budae Jjigae Noodle Soup--->农心部队锅拉面
QIAO NIANG FANG QLF BEAN PASTE--->巧酿坊郫县豆瓣
LEE KUM KEE SEASONED SOY SAUCE 1.9L--->李锦记味极鲜酱油1.9L
NISSIN UDON BONITO FLVAOUR--->出前一丁鲣鱼味乌冬
LAVONS LAUNDRY DETERGENT MACARON--->LAVONS甜蜜洗衣液
Greenmax Roasted Brown Rice Milk Tea--->马玉山炭香玄米奶茶
Taichung Honey Sun Cake--->太阳堂蜂蜜太阳饼
T&T SHOPPING BOX--->T&T环保购物盒
EMF BLUE CRANE CHOPSTICK--->EMF 千鹤日本筷
DMDQ BAMBOO SHAPE EGG NOODLES--->东明大桥鸡蛋面
DMDQ MUNG BEAN VERMICELLI--->东明大桥龙口粉丝
DMDQ SWEET POTATO NOODLES--->东明大桥红薯粉
Vita Lime Lemon Tea--->维他青柠柠檬茶
T&T SLICED STRAW MUSHROOM--->T&T切粒鲜草菇
NIN JIOM UME PLUM FLAVOUR HERBAL CANDY--->念慈庵乌梅润喉糖
JINMAILANG STEW BEEF NOODLE--->今麦郎红烧牛肉面
MERILIN RADIX CODONOPSIS PILOSULAE--->美林绞党参
Indomie Instant Fried Noodles 5 Pack--->营多印尼炒面5 包
T&T Coconut Milk--->T&T椰奶
T&T Crispy Dried Pork Floss With Seaweed--->T&T海苔芝麻肉松
T&W BLACK PEPPER LOBSTER FLAVOUR CHIPS--->台味黑胡椒龙虾片
HADALABO GOKUJYUN HYALURONIC MILK--->肌研极润玻尿酸保湿乳液
Great Mountain Ginseng Chips--->大山行花旗蔘碎
T&T SOMEN NOODLE--->T&T 素面
KAO MAGICLEAN GREEN APPLE KITCHEN CLEANER--->花王青苹果厨房清洁
T&T ORGANIC GREEN TEA (TEA BAGS)--->T&T 有机绿茶茶包
Shanyuan Dried Mushroom--->山缘冬菇
LG BAMBOO SALT TOOTHPASTE--->LG竹盐牙膏
EVER GROWTH ORIGINAL FLAVOUR SUNFLOWER SEEDS--->香香原味葵瓜子
KINGO SICHUAN PRICKLY ASH--->金谷四川花椒
KINGO GREEN PRICKLY ASH--->金谷青花椒
Agf Blendy Stick Sugar Free Coffee--->AGF无糖即溶咖啡
AGF BLENDY STICK ORIGINAL COFFEE--->AGF原味即溶咖啡
KINGO FIVE FLOWER TEA--->金榖五花茶
YOUJOY HANYUAN PEPPER OIL--->友加汉源花椒油
SHWNQ BISCUIT--->上海万年青饼乾
PHILIPPINE DRIED MANGO SLICE--->菲律宾芒果乾
HENGSHUN ZHEN JIANG 6YR AGED VINEGAR--->恒顺六年陈香醋
Lee Kum Kee Abalone Sauce--->李锦记鲍鱼汁
LARBEE PINK PIG JELLY--->蜡笔小新粉猪果冻
Kadoya Shiro Goma--->八角烤白芝麻
SIX-F BALCK PEPPER POWDER--->六福黑胡椒粉
UNICO CHICK PEAS--->原力高嘴豆
LKK CHILI BEAN SAUCE - L--->李锦记辣豆瓣酱大
LAO ZHONG YI HERBAL TEA--->老中医甘四味
LAO ZHONG YI CLEAN UP WET TEA--->老中医热湿茶
7D DRIED MANGO SLICE--->7D芒果乾
Liuquan Potato Vermicelli Sheets--->六泉坊马铃薯粉皮
Fulinmen Dongbei Premium Rice--->福临门东北大米
T&T RICE STICK- MEDIUM--->T&T沙河粉-中
T&T WHOLE WATER CHESTNUT--->T&T原粒马蹄
T&T SLICED WATER CHESTNUT--->T&T马蹄片
T&T Lychee In Syrup--->T&T 糖水荔枝
Chacha Original Sunflower Seeds--->洽洽原味香瓜子
MYOJO DRIED NOODLE SAUCE YAKISOBA--->明星酱油炒面
T&T FORTUNE COOKIES--->T&T 幸运饼
DMDQ DRIED LILY FLOWER--->东明大桥金针菜
DMDQ DRIED ANGELICA--->东明大桥当归片
Nestle Premium Unsweetened White Coffee--->雀巢无糖极品白咖啡
ZHEN XIANG BBQ BEEF FLAVOUR SOY PROTEIN MEAT--->祯香肥牛大豆素肉
Kumano Horse Oil Body Wash--->熊野马油沐浴露
WANT WANT HOT-KID QQ APPLE GUMMY--->旺旺QQ苹果软糖
Papa Recipe Bombee Honey Whitening Mask--->春雨蜂胶美白面膜
ZHEN XIANG BRAISED BEEF FLAVOUR SOY PROTEIN MEAT--->祯香牛肉大豆素肉
GOLDEN NEST HONEY GLAZED BEEF JERKY--->金燕窝蜂蜜烧烤牛肉乾
GOLDEN NEST HONEY TERIYAKI BEEF JERKY--->金燕窝蜂蜜照烧牛肉乾
Golden Nest Honey Glazed Grilled Pork Jerky--->金燕窝蜂蜜烧烤猪肉乾
Dashanhe Dried Seaweed--->大山合紫菜
GUANGYOU SPICY CHONGQING NOODLE--->光友麻辣重庆小面
Okamoto Condom 001 Zero One Red--->冈本001 红盒保险套
Nestle Green Tea Mini Kitkat--->雀巢抹茶奇巧
LAOJIEKOU CHINESE PECAN FLAVOUR SUNFLOWER SEEDS--->老街口山核桃瓜子
JULIANG ORGANIC CORN FLOUR--->巨量有机玉米面粉
Tseng Noodles Spicy Sichuan Pepper Flavor--->曾拌面-椒麻油香
P&G Refreshing Fragrance Laundry Detergent Ball--->宝洁魔力洗衣球
SUNNYMARK ORIGINAL FRIED FISH SKIN--->新唛原味香脆鱼皮
Sunity Chrysanthemum Chinese Herbal Jelly--->生和堂菊花龟苓膏
THERMOS STAINLESS VACUUM FLASK P--->膳魔师炫彩保温杯P
TAMANOHADA SHAMPOO 004 GARDENIA--->玉肌无硅洗发水004栀子花
TAMANOHADA CONDITIONER 004 GARDENIA--->玉肌无硅护发素004栀子花
JIU SHUN DA MUSHROOM SOUP PACK--->九顺达六菌汤
HACKERS CHONGQING STYLE SELF-HEATING HOT POT--->蜀客行毛肚自煮锅
Hackers Sichuan Self-Heating Hot Pot--->蜀客行冒菜自煮锅
YIJIANGNAN DAHONGPAO BLACK TEA--->忆江南大红袍茶
T&T Spicy Pork Jerky--->T&T辣味烧烤猪肉乾
Juliang Wild Peach Gum--->巨量野生桃胶
T&T Spicy Korean Kalbi Marinade Sauce--->T&T辣牛仔骨酱
BAIJIA SICHUAN STYLE DANDAN NOODLE--->白家四川担担面
JIANGZHONG HOUGU BREAKFAST RICE CEREAL--->江中猴姑早餐米稀
Svelty Pakkun Yeast Enzyme--->SVELTY糖质分解
H&H Dried Golden Apricot--->H&H黄金杏子
WEI-LONG SPICY CRISPY KELP--->卫龙脆辣海带
Amino Mason Moist Shampoo--->AMINO MASON胺基酸植物洗发水
Amino Mason Smooth Shampoo--->AMINO MASON胺基酸柔顺洗发水
T&T Mix Nut(Unsalted)--->T&T杂锦果仁(无盐)
Jm Solution Bird Nest Moisture Mask--->JM SOLUTION 燕窝滋养补水面膜
Lion Handsoap Blooming Refill--->狮王兰花洗手液补充装
Sunity Purple Rice & Milk Hebbal Jelly--->生和堂椰紫龟苓膏
Sunity Double Honey Herbal Jelly Pouch--->生和堂蜂蜜龟苓爽
Sunity Sugar Lily Chinese Herbal Jelly--->生和堂百合龟苓膏
Hao Huan Luo Spicy Rice Noodle 400G--->好欢螺螺蛳粉400g
Golden Nest Sugar Swallow Nest--->金燕窝有机冰糖燕窝
Lkk Sauce For Sichuan Style Mapo Tofu--->李锦记四川麻婆豆腐酱
Amino Mason Smooth Treatment--->AM氨基酸柔顺护发素
T&T Garlic Roasted Peanuts--->T&T 蒜香味烤花生
T&T Organic Thai Brown Jasmine Rice--->T&T有机泰国香糙米
GLICO TIRAMISU COOKIES--->固力果提拉米苏百醇
GLICO SPICY PIZZA COOKIES--->固力果微辣比萨百力滋
ENERGY RIVER SNAIL RICE NOODLE--->食族人螺蛳粉
Wgdc Bamboo Beef Flavour Instant Noodle 5Pk--->五谷道场酸笋肥牛面
Wugudaochang Kelp Rib Flavour Instant Noodle--->五谷道场海带排骨面
SHUN SAVORY CABBAGE FLAVOR NOODLE--->顺香春老坛酸菜拌面
GLICO PEJOY MATCHA LATTE BISC STK--->固力果抹茶拿铁力百醇
Wugudaochang Beef Instant Noodle--->五谷道场红烧牛肉面
HRBL INSTANT SPICY VERMICELLI--->嘿人部落关东煮
ITSUKI HOKKAIDO YUZUSHIO RAMEN--->五木北海道日本拉面
UNITED COFFEE CANDY--->联合原味咖啡糖
Longkow Vermicelli--->龙口围炉粉丝
YBC LANGUE DE CHAT COOKIE--->YBC朗格多奶油曲奇
CHUN GUANG COCONUT CANDY--->春光特制椰子糖
ZHONGWANG SASAME PETITE PATE FRITE TWIST--->众望芝麻味小麻花
Y&Y LONGKOU VERMICELLI--->如意龙口粉丝
ONTRUE PURPLE SWEET POTATO VERMICELLI--->安厨紫薯粉丝
GLICO COLLON MATCHA BISC ROLL--->固力果抹茶奶油圈
KOLOKO PEA CRACKERS- EXTREME SPICY--->可乐果碗豆酥- 超激辣
HRBL VERMICELLI DONJAC HOT&SPICY--->嘿人爆肚酸辣粉
GLICO POCKY ZEITAKU GREEN TEA--->日本固力果浓抹茶百奇
ZHEN MIAN GUAN NON-FRIED EGG NOODLES--->珍面馆非油炸全蛋面
JFL DRIED LILY--->嘉福利黄花菜
CL BLACK ORGANIC HERBAL HAIR COLOR--->CL黑色纯植物染发剂
CL DEEP CHESTNUT ORGANIC HAIR COLOR--->CL深栗纯植物染发剂
NONGSHIM SEAFOOD NOODLE--->农心海鲜汤面
WU FENG WILD PEPPER OIL--->五丰黎红藤椒油
CHEN KE MING UDON--->陈克明乌冬面
HEALTHY GRAIN MIX--->花唛健康糙米
PAD THAI SAUCE--->鸡牌泰式炒河酱
MITSUKAN AJI PON--->调味汁
ASIAN HOME GOURMET TOM YUM SOUP--->佳厨泰国冬阴汤酱
ASIAN HOME GOURMET SZECHAN HOT&SOUR SOUP--->佳厨四川酸辣汤酱
BAMBOE INDO INST SPICES BEEF SOUP--->印尼牛肉汤调料
DIAMOND G CALIFORNIA BROWN RICE--->钻石G糙米
GALLO OLIVE OIL--->GALLO 橄榄油
OX HEAD BROWN RICE--->牛头泰国糙米
PACIFIC GOLD BLACK GLUTINOUS RICE--->财仔紫糯米
COCK FISH SAUCE-SMALL--->鸡牌鱼露-小
LION&GLOBE PEANUT CANOLA OIL-2L--->狮球唛花生芥花籽油
SAPORITO CANOLA OIL--->SAPORITO芥花籽油
KIKKOMAN RICE VINEGAR--->万字米醋
RICEMATE BLACK BROWN RICE--->米伴紫黑米
KINGO JASMINE RICE (2KG)--->金谷茉莉香米 2KG
FULINMEN HETAO SNOW WHEAT FLOUR--->福临门雪花小麦粉
MAMA SHR CREAMY TOMYUM JUMBO--->妈妈酸辣虾味面
YOUJIA DANDAN NOODLES CONDIMENT--->友加担担面调料
KLEANNARA COTTON SANITARY PAD 33CM--->KN纯棉夜用33CM
ONTRUE YELLOW MILLET--->安厨东北黄小米
Juliang Organic Millet Flour--->巨量有机大黄米面
BIGEN LIGHT BROWN ONE PUSH #3--->美源浅棕OP#3
BIGEN MEDIUM BROWN ONE PUSH #4--->美源亮棕OP#4
GLICO MINI CALPICO--->日本固力果迷你甜筒
SHISEIDO SUPER MILD FLORAL FRUITY CONDITIONER--->资生堂超柔鲜花护发素
Old Town Cane Sugar 3 In 1 White Coffee--->旧街场蔗糖白咖啡
EMF BLUE WOOD CHOPSTICK--->EMF棕/蓝日本筷
DMDQ TIEGUANYIN OOLONG TEA--->东明大桥铁观音
DMDQ SELECTED AGED PU ERH TEA--->东明大桥珍藏版陈年普洱
TUNG-I BEEF W/SAUERKRAUT SUPER BWL NDLE--->来一桶酸菜牛肉面
GOLD STAR BUTALN GAS--->金星瓦斯筒
Sato Q10 Collagen Drink--->佐藤Q10 胶原蛋白
T&T WHOLE STRAW MUSHROOM--->T&T原粒鲜草菇
SOUTH WORD ROCK CANDY--->南字黄冰糖
SOUTH WORD BROWN CANDY IN PIECES--->南字包装片糖
Mandom Barrier Super Moist Mask--->曼丹贝儿超保湿面膜
T&T Dried Shiitake Mushrooms--->T&T茶花菇
LION SYSTEMA KIDS TOOTHBRUSH AGE 3-6--->狮王适齿美3-6嵗儿童牙刷
Lianfeng Hickory Nut Kernels--->莲峰小核桃仁
LIANFENG HAND SHELLED HICKORY NUT KERNELS--->莲峰手剥小核桃
NUTELLA HAZELNUT SPREAD--->睦泰箂巧克榛果酱
NISSIN SESAME OIL NOODLE--->出前一丁麻油
JINMAILANG STEW PORK NOODLE--->今麦郎葱烧排骨面
BLUE DIAMOND ROASTED SALTED ALMOND--->蓝钻石盐烤杏仁
Ucc Blend Coffee--->上岛114柔顺咖啡
Prima Taste Laksa La Mian--->百胜厨叻沙拉面
Hsus Ginseng Tea--->许氏花旗参茶
AMOY SWEET SOY SAUCE--->淘大煲仔饭豉油
Juliang Organic Black Bean--->巨量有机黑豆
Glico Pocky Strawberry Crush Biscuit Stick--->固力果草莓粒百奇
T&T Dried Pork Floss--->T&T猪肉松
Shinho Soy Sauce For Braised Dishes--->欣和六月鲜红烧酱油
MALTESERS--->麦提莎巧克力
T&W ORIGINAL LOBSTER FLAVOUR CHIPS--->台味原味龙虾片
Bifesta Bright Up Cleansing Lotion--->BIFESTA抗暗沉即净卸妆水
Dr.Morita Moisturizing Facial Mask--->森田保湿面膜
T&T SALTED CASHEWS--->T&T 盐味腰果
GREAT MOUNTAIN GINSENG HONEY--->大山行花旗蔘蜂蜜
GOLDEN BONBON ASSORTED ALMOND NOUGAT SOFTCANDY--->加宝什锦软鸟结糖
KIKKOMAN UNAGI SUSHI SAUCE--->万字蒲烧鳗鱼汁
Ucc Selected Instant Coffee--->上岛特纯即溶咖啡
WAN JA SHAN MIRIN--->万家香味醂
FU CHE SPICY HARD BOILED QUAIL EGGS--->福记辣味鹌鹑蛋
PINEAPPLE CAKE--->一口凤梨酥
DMDQ YUNNAN RICE NOODLES--->东明大桥云南米线
DMDQ LICORICE FLAVOUR WATERMELON SEEDS--->东明大桥甘草黑瓜
HAIDILAO SEAFOOD HOT POT SOUP BASE--->海底捞三鲜火锅底
A-Sha Tainan Noodle- Sesame--->阿舍台南麻酱乾面
JULIANG PEARL BARLEY--->巨量薏米
TOYAMA HORSE OIL SHAMPOO--->富山马油洗发露
TOYAMA HORSE OIL CONDITIONER--->富山马油护发露
T&T Premium Light Soy Sauce--->T&T 特级生抽
T&T Fine Dry Noodles--->T&T山东拉面(细条)
T&T Medium Dry Noodle--->T&T山东拉面(中条)
QISHEN BARBECUE SEASONING--->杞参烤肉串专用粉
T&T SRIRACHA CHILI SAUCE--->T&T 是拉差辣椒酱
T&T ORGANIC OOLONG TEA (TEA BAGS)--->T&T 有机乌龙茶包
GREAT MOUNTAIN GINSENG MILK TEA--->大山行花旗参奶茶
HYDRANGEA GLUTINOUS RICE--->紫阳花糯米
TIGER MICOM RICE COOKERS 5.5 CUPS JAX-T10--->虎牌5.5杯料理饭锅
T&T Longkow Vermicelli--->T&T 台湾龙口粉丝
GLICO POCKY GREEN TEA BISCUIT STICK--->固力果绿茶百奇
Sugo Greaseless Salted & Garlic Peanuts--->SUGO蒜味去衣花生
EVERY GREEN CHILI PEPPER SLICES--->老山货辣椒段
GUM SOFT PICKS--->GUM齿纹牙签
Kumano Horse Oil Shampoo--->熊野马油洗发水
FISH WELL CRISPY PRESERVED VEGETABLE--->鱼泉牌丁丁香榨菜
NIN JIOM APPLE LONGAN FLAVOUR HERBAL CANDY--->京都念慈庵润喉糖
CHUANNAN CRISP PICKLED MUSTARD--->川南口口脆榨菜片
HADAY SOY SAUCE FOR STEAMED FISH--->海天蒸鱼豉油
CONGSHAN DRIED MUSHROOM--->丛山香菇
Glico Pretz Salad Biscuit Stick--->固力果沙律百力滋
LEE KUM KEE SEAFOOD XO SAUCE--->李锦记海皇XO酱
Heyu Cordyceps Flower--->禾煜虫草花
Ryoe Normal Dry Scalp Hair Loss Repairing Shampoo--->吕中干性头皮防脱生发洗发水
Ryoe Sensitive Scalp Hair Loss Repairing Shampoo--->吕敏感头皮防脱生发洗发水
Paldo Cheese Noodle--->八道起司拉面
FRIED SHALLOT--->宏牌台湾油葱酥
GOLDEN BUFFALO BEAN THREAD--->金牛牌台湾粉丝
WEI RONG ORGANIC BLACK BEANS DRY--->味荣有机乾豆豉
WANG ORIENTAL STYLE NOODLE--->皇牌炸酱面
HOE HIN WHITE FLOWER ANALGESIC BALM--->和兴大号白花油
RICE WINE 9.5% W/SALT 1.5%--->红瓦厝台湾米酒9.5度
BJ FRAGRANT SPICY FISH--->白家香辣水煮鱼调料
KKM TERIYAKI SAUCE GARLIC & GREEN ONION--->万字蒜蓉照烧酱
NONGSHIM POTATO PORK RAMAN 5PK--->农心土豆排骨拉面
Mama Chicken Instant Noodle Pack 5--->妈妈鸡汤面5包
XPL SWEET & ALCOHOLIC BEAN CURD--->江记甜酒豆腐乳
DRY MUSHROOM- SMALL SIZE--->埔里香菇- 小
SHINHO SOY BEAN PASTE--->欣和葱伴侣豆瓣酱
BOTAN MUSENMAI--->牡丹圆米
CHUANNAN SPICY SHREDDED KELP--->川南麻辣海带丝
Unico Spaghetti--->原力高意大利粉
TARAMI HOKKAIDO MELON JELLY--->达乐美北海道密瓜果冻
DOLE PINEAPPLE WATER JELLY--->DOLE果汁果冻-凤梨
LEE KUM KEE OYSTER SAUCE WITH DRIED SCALLOP 510g--->李锦记干贝蠔油510g
FREEPLUS MILD SOAP--->芙丽芳丝氨基酸洁面乳
NISSIN UDON CURRY--->出前一丁咖哩乌冬
FREEPLUS MILD MOISTURE SOAP--->芙丽芳丝凈润泡沫洗面奶
LAVONS LAUNDRY DETERGENT LUXURY--->LAVONS奢华洗衣液
WU XIAN ZHAI CUMIN DIRED TOFU--->五贤斋孜香素牛肚
WU XIAN ZHAI HOT DIRED TOFU--->五贤斋香辣味素牛肚
T&T Thai Jasmine Rice 18Lb--->T&T泰国茉莉香米18LB
Sante Beauteye Rose Eye Drops--->参天红玫瑰眼药水
On Kee Abalone Gift Set--->安记地道鲍鱼礼盒
Mizkan Cheese Vegetable Soup Base--->味滋康鲜浓芝士汤底
Zhang Jun Ya Seaweed Flavour Noodle Snack--->张君雅五香海苔丸子
MISE EN SCENE MERMAID GREEN 4GN--->爱茉莉人鱼绿染发剂4GN
SUNITY HONEY HERBAL JELLY--->生和堂菊蜂蜜龟苓膏
SUNITY ROSE SUGAR HERBAL JELLY--->生和堂玫瑰黑糖龟苓
Sunity Coffee Herbal Jelly--->生和堂咖啡味烧龟苓
Sunity Hongkong Style Milk Tea Herbal Jelly--->生和堂港式丝袜奶茶烧龟苓
Sunity Mulberry Herbal Jelly--->生和堂桑抹味烧龟苓
Sunity Ginseng Honey Herbal Jelly--->生和堂参蜜龟苓膏
INSTAFERM YEAST-INSTANT--->INSTAFERM酵母粉
LKK SICHUAN HOT&SPICY SOUPBASE/HOT POT--->李锦记麻辣火锅汤
LKK BLACK BEAN CHILI SAUCE--->李锦记豆豉辣椒酱
JIA FU LI BAMBOO LEAVES--->嘉福利竹叶
NISSIN MISO TONKOTSU RAMEN--->出前一丁味噌棒丁
NISSIN AKA TONKOTSU RAMEN--->出前一丁赤骨棒丁
LGF DRIED BEAN STRING--->良工坊云南豆腐丝
HEYU BAMBOO FUNGUS--->禾煜竹荪
Lion Moisturizing Peach Handsoap--->狮王桃子洗手液
WEI-LONG SPICY POTATO SLICES--->卫龙麻辣土豆片
LEE KUM KEE SAUCE FOR MAPO TOFU--->李锦记麻婆豆腐酱
Want Want Green Onion Golden Rice Cracker--->旺旺小酥葱香鸡经济包
Delta Blue Spicy Salted Egg Fish Skin--->DELTA BLUE辣味咸蛋香脆鱼皮
Fan Sao Guang Enoki Mushrooms Pickles--->饭扫光爆炒金针菇
FAN SAO GUANG PRESERVED MUSHROOMS--->FAN SAO GUANG PRESERVED MUSHROOMS
Pami Black Sesame Flavor Tseng Noodles--->曾拌面-黑金芝麻
Glico Spicy Shrimp Flv Cookies--->固力果微辣虾百力滋
Zdl Preserved Mustard--->真的老泡酸菜
Nissin Tonkotsu Big Cup Noodle--->合味道猪骨浓汤大杯
Yumei Self-Heating Fish Spicy Soup--->与美水煮鱼自热锅
Ryo Deep Cleansing Shampoo--->吕头皮洁净洗发水
Liuquan Luosi Noodle--->柳全航海原味螺蛳粉
Little Sheep Spicy Hot Pot Dipping Sauce--->小肥羊香辣火锅蘸料
Unico Red Kidney Beans--->原力高腰豆
Aroy-D Canned Tom Yum Soup--->阿罗地泰式酸辣汤
Camp Chunky N.E. Clam Chowder--->金宝蚬周打汤
Rice Sticks (Fine-1Mm)--->如意牌炒河粉
Kikkoman Tofu Miso Soup--->万字豆腐面豉汤
Face Shield--->防护面罩
Disinfectant Spray--->医用专业消毒喷雾
Mediheal Labocare Sun Spray--->可莱丝修复防晒喷雾
Haday Spicy Bake Mix Powder--->海天盐焗鸡粉
NG FUNG INST.RICE VERMICELLI--->五丰银丝米粉
GO CHA OYSTER FLV DRIED NOODLE--->古早蚵仔面线
PAGODA LUNGKOW VERMICELLI (BLUE)--->塔牌龙口粉丝
Pagoda Lungkow Bean Thread(Blue)--->塔牌龙口粉丝
COCK TAPIOCA PEARL (SMALL)--->鸡牌西谷米(细)
RICE STICKS (MEDIUM-5MM)--->如意牌沙河粉
MISHIMA AJINORI FURIKAKE BTL--->味海苔拌饭料
Italpasta Penne Rigate Pasta--->IP斜桶意大利面
Golden Apple Black Flour Paste--->金苹果酱皇壶底豆豉王
Samyang Hot Chicken Big Bowl--->三养超辣鸡肉碗面
Marutai Miyazaki Salt Chicken Noodles--->丸太宫崎盐面
MIN SHAN LIU WEI DI HUANG WAN--->MIN SHAN LIU WEI DI HUANG WAN
Qp Mayonnaise 1Kg--->优比美乃滋1KG
Pc Himalayan Rock Salt Grinder--->PC喜马拉雅盐
BOTANIST SMOOTH TREATMENT--->BOTANIST SMOOTH TREATMENT
Kao Hot Eye Mask Citrus--->花王蒸汽眼罩-柑橘
Unny Mild Cleansing Foam--->UNNY氨基酸洗面奶
Youjia Spice For Bbq--->友加烧烤料
Youjia Star Anise--->友加八角
Youjia Ma Po Tofu Comdiment--->友加麻婆豆腐调料
Kleanara Cotton Sanitary Pad 26Cm--->Kleanara纯棉日用26CM
Kleannara Cotton Sanitary Pad 29Cm--->Kleannara纯棉日用29CM
PRINCE OF PEACE GINGER HONEY CRYSTAL--->太子速溶姜王晶
NONGSHIM KIMCHI NOODLE--->农心辣白菜拉面
SHJ GARLIC GREEN PEAS--->盛香珍蒜香青豆
GREENMAX YAM & MULTI GRAINS CEREAL--->马玉山山药粥
WU TSEN PRESERVED BAMBOO SHOOT--->伍珍云山香脆云笋
Sau Tao Shrimp Noodles--->寿桃特级虾子面
TONGXIANG PRESEVED WAXBERRY--->同享九制杨梅
A+ JAPANESE STYLE SOMEN NOODLE--->A+日式素面
SLIM LEAF EXTRA STRENGTH SUPER SLIM TEA--->极品清秀茶加强版
Quaker One Minute Oats--->桂格一分钟麦片
Koikei Almond Cookie--->钜记原粒杏仁饼
SHJ LIQUORICE FLAVOUR WATERMELON SEEDS--->盛香珍甘草瓜子
KINGO GLACED DATES--->金谷牌蜜枣
KINGO WHITE SESAME--->金谷白芝麻
Spam Low Sodium Luncheon Meat--->SPAM低钠午餐肉
EVERY GREEN COMPRESSED BLACK FUNGUS--->老山货压缩黑木耳
Bigen Speedy Hair Color Natural Black--->美源发彩自然黑
EXCEL SPEARMINT GUM BOTTLE--->益达瓶装无糖薄荷口香糖
White Sprit Bear Smoked Wild Salmon Gift Box--->白熊精装三文礼盒
KNORR ORIGINAL SEASONING SAUCE--->家乐牌原味菲式调料
SAU TAO ABALONE RICE VERMICELLI--->寿桃小桥米线鲍鱼味
VITAWRAP FOOD WRAP WITH SLIDE BLADE--->VITAWRAP保鲜膜带胶刀
EMF STEAM RACK SS 7X3 INCH--->EMF 不锈钢蒸架
DOUBLE SWALLOW KONG MOON RICE STICK--->双燕牌江门排粉
SHJ MANGO FLAVOUR COCONUT JELLY--->盛香珍芒果果冻
MASTERKON ICE TEA--->康师傅冰红茶-
Mazola Canola Oil--->万岁纯芥花籽油
JUANCHENG CHILI FERMENTED BEANCURD--->鹃城红油豆瓣酱
Sun Kung Meal Box 0.85Ml--->三光牌饭壶0.85ML
GREEN FARM ORGANIC SOYBEAN--->青的农场有机黄豆
Nongshim Shrimp Flavoured Chips--->农心虾片
Kewpie Half Calorie Mayonnaise--->优比低卡美乃滋
Kewpie Roasted Sesame Dressing--->优比焙煎胡麻酱
GLASSLOCK CONTAINER SQUARE 900ML--->GL玻璃保鲜盒方型900ML
MASTER SARDINES IN TOMATO SAUCE--->马士达茄汁沙丁鱼
Great Mountain Ginseng Slices--->大山行花旗蔘片
DOUBLE COINS ORIGINAL GRASS JELLY--->双钱原味龟苓膏
T&T Clear Chicken Broth--->T&T清鸡汤
T&T Pure Honey--->T&T纯天然蜂蜜
T&T Black Sesame Dessert--->T&T黑芝麻糊
HONG YUAN GUAVA CANDY--->宏源番石榴夹心糖
Nissin Demae Itcho Bowl - Sesame Oil--->出前一丁麻油碗面
Nissin Demae Itcho Bowl - Chicken--->出前一丁鸡蓉碗面
BY ORIENT INDUCTION RANGE 1300W--->东枋高效电磁炉1300W
PALDO CHAJIANG NODDLE--->八道御膳炸酱面
Ls Hot Pot Soup Base-Plain--->小肥羊清汤火锅料
GOLDEN APPLE FRIED BROAD BEAN--->金苹果莲花豆
Taokaenoi Original Crispy Seaweed Snack--->小老板原味脆紫菜
ALFA ONE RICE BRAN OIL--->ALFA ONE稻米油
OISHI PRAWN FLAVOUR FLAKES--->上好佳虾片
MEI YUAN MINT PRESERVED SEEDLESS PRUNE--->美元梅好冰梅肉
KIKKOMAN SEASONED RICE VINEGAR--->万字米醋
QIANPU DRIED SEAWEED WITH TOFU & MUSHROOM--->千浦豆腐蘑菇紫菜
SUN CUMIN RICE CRACKER--->太阳孜然口味锅巴
YUYUAN SLICE PRESERVED CHINESE CABBAGE--->榆园东北酸菜丝
NISSIN SALT CHICKEN NOODLE--->日本日清函馆盐香面
SIX FOURTUNE HSIN TSU RICE STICK--->六福新竹米粉(包)
SHIRAKIKU CUT WAKAME--->白菊印碎海带
Nissin Cup Ndl-Crab--->合味道蟹柳杯面
GLICO MILD HOT CURRY--->固力果小辣咖哩
Windsor Salt (Box)--->温沙盐
SEASONS SPICY BAKE MIX FOR CHICKEN--->四季盐焗鸡粉
S&B WASABI TUBE FAMILY SIZE--->S&B日本芥茉酱
Shirakiku Azuki Red Bean--->白菊印红豆910G
Kadoya Kuro Goma--->八角烤黑芝麻
GOLDEN COINS MANGO PUDDING MIX--->金钱芒果布丁粉
BILLY BEE LIQUID-BEEHIVE--->BILLY BEE纯蜂蜜-尖嘴
CENTURY HOT&SPICY TUNA FLAKE--->世纪辣吞拿鱼片
Kirin Gogono Koucha Straight Black Tea--->午後红茶
Loacker Quad Napolitan Wafer--->莱家榛子粒威化
LOACKER QUAD CHOCOLATE WAFER--->莱家巧克力粒威化
LEE KUM KEE CHIU CHOW CHILI OIL--->李锦记潮州辣椒油
SQUID BRAND FISH SAUCE--->鱿鱼牌鱼露
MIZKAN OIGATSUO TSUYU SOUP BASE--->味滋康四倍浓缩汤料
KIMLAN RICE VINEGAR--->金兰米醋
DATU PUTI VINEGAR--->DATU PUTI菲式白醋
Gp Chin Kiang Vinegar--->金梅镇江香醋
PAT CHUN SWEET VINEGAR--->八珍甜醋
CHOI HEONG YUEN ALMOND COOKIE--->咀香园杏仁饼
FERRERO RAFFAELLO TRI-PACK--->金莎白雪巧克力
Amoy Gold Label Dark Soy Sauce--->淘大金标老抽
KIMLAN DARK SOY SAUCE--->金兰老抽
Kikkoman Soy Sauce--->万字酱油罐
Kikkoman Less Sodium Sauce--->万字低盐酱油
Lee Kum Kee Black Pepper Saucem--->李锦记黑椒汁
LEE KUM KEE MARINADE SAUCE--->李锦记卤水汁
Lee Kum Kee Premium Oyster Sauce--->李锦记旧庄蚝油
JUFRAN ORGINAL BANANA SAUCE--->JUFRAN菲式原味甜辣酱
Nongshim Udon--->农心乌冬面五包装
SHJ DRIED LITTLE FISH WITH PEANUT--->盛香珍小鱼干花生
AROY-D LYCHEE IN SYRUP--->阿罗地糖水荔枝
Billy Bee Liquid Honey-Bear--->BILLY BEE天然蜂蜜-熊仔
LOT 100 MANGO GUMMY CANDY--->一百分芒果软糖
JANE JANE ORIGINAL PREPARED SHREDDED SQUID--->珍珍原味鱿鱼丝
HAPPY DRIED SWEET PRUNE--->欢乐大甜话梅
S&B Mild Curry--->S&B甘口咖哩
S&B HOT CURRY--->S&B辣咖哩
BEAUIDEAL SUPERIOR PICKLE SAUCE--->宝鼎金标糟卤
KIMLAN CHILI BAMBOO SHOOT--->金兰辣笋茸
S&B GOLDEN MILD CURRY--->S&B甘口金装咖哩
Ricola Blackcurrent Fresh Gummy Pearls--->利口乐提子橡皮糖
UJINOTSUYU SENCHA JAPANESE TEA--->宇治之露煎茶
JANE JANE HOT PREPARED SHREDDED SQUID--->珍珍辣味鱿鱼丝
SIX FORTUNE ORIGINAL PREPARED BROAD BEAN--->六福原味蚕豆
PAGODA SHAOXING COOKING WINE--->塔牌咸绍兴酒
CALBEE CURRY POTATO CHIPS--->卡乐B 咖哩薯片
PALM GARLIC CORNED BEEF--->棕榈树蒜味碎牛肉
MARUKYO MEISAKU ASSORTED CAKE--->丸京味铭作和果子
Canaan Citron Tea--->加南韩国柚子茶
KASUGAI PEACH GUMMY--->春日井水蜜桃软糖
JM SOLUTION WATER LUMINOUS SILKY COCOON MASK--->JM SOLUTION水光丝滑蚕丝面膜
WONJIN EFFECT MEDI HYDRO VIAL MASK--->原辰透明质酸安瓶面膜
Metro Yamanashi Peach Juice--->日本山梨县特产桃子汁
GOLDEN NEST HONEY LOQUAT SWALLOW NEST BEVERAGE--->金燕窝枇杷燕窝
Elmie Underwear Blood Stain Laundry Detergent--->Elmie杀菌祛渍内衣洗剂
Lee Kum Kee Soy Sauce For Seafood Value Pack--->李锦记蒸鱼优惠包
LUX SOFT KISS BODY WASH--->丽仕水嫩柔肤沐浴乳
XIZHILANG STRONG TANGERINES FRUIT JELLY--->喜之郎果冻蜜橘
PALDO GOMTANG NOODLE--->八道牛骨汤面
Sofy Overnight Cotton Sanitary Pads 41.5Cm--->苏菲超熟睡棉柔卫生棉41.5CM
A-Sha Original Hakka Noodle--->阿舍原味客家板条
Arctic Ocean Mandarin Soda--->北冰洋橘味汽水
Arctic Ocean Orange Soda--->北冰洋橙味汽水
NHY RICE VERMICELLI--->南湖缘云南过桥米线
Samkwang Almond Green Tea Spread--->SW杏仁抹茶酱
KAO MERRIES BABY DIAPER SIZE S 82 SHEETS--->花王纸尿布小号82片
Kao Merries Baby Diaper Size M 64 Sheets--->花王纸尿布中号64片
OREO VANILLA CRISPY BISCUIT--->日版香草拿奥利奥
TAMANOHADA SHAMPOO DISPENSER--->玉肌压力泵头
LAOHENGHE CALLON&GINGER COOKING WINE--->老恒和姜葱料酒
T&T 3IN1 COFFEE 25%REDUCED SUGAR--->T&T三合一减糖咖啡
T&T Xinjiang Hetian Red Dates--->T&T新疆和田枣
Megumi Onsen Moisture Mask--->惠之本舖温泉保湿面膜
MASTERKON GOLDEN BEEF SOUP NOODLE--->康师傅金汤肥牛面
CJ Lion Sensitive Foam Handsoap--->常绿秀敏感肌肤泡沫洗手液
JULIANG ORGANIC CORN GRITS--->巨量有机玉米槮
Sunity Longan & Milk Herbal Jelly--->生和堂奶香桂圆龟苓膏
Cedarwood Creamed Honey--->CEDARWOOD加拿大白蜂蜜
T&T Maple Flavour Pork Jerky--->T&T枫糖猪肉乾
LAYS TOMATO FLAVOUR POTATO CHIPS--->乐事真浓番茄薯片
LAYS LIME FLAVOUR POTATO CHIPS--->乐事青柠味薯片
BAIJIA SHANXI STYLE YOUPO NOODLE--->白家陕西油泼面
Ribena Concentrated Blackcurrant Beverage--->利宾纳黑加仑子汁
T&T Mix Nut(Sea Salt)--->T&T杂锦果仁(海盐)
Jm Solution Pink Snail Brightening Mask--->JM SOLUTION 蜗牛原液亮白面膜
Jm Solution Active Goldencaviar Nourishing Mask--->JM SOLUTION 鱼子酱紧致面膜
Jm Solution Active Jellyfish Mask--->JM SOLUTION 水母弹润补水面膜
Dr Wonjin Cica Dressing Solution Mask Set--->原辰舒缓面膜套装(送洁面)
Sunity Mung Bean Milk Herbal Jelly Pouch--->生和堂奶绿龟苓膏
Ichiei Shyokuhin White Peach Bean Jam Dorayaki--->日本一荣白桃铜锣烧
Lee Kum Kee Chili Xo Sauce--->李锦记XO酱
Dettol Antispt--->滴露消毒液
Tk Food Salty Egg Yolk Cookie--->老杨咸蛋黄饼
JINZAI SAUCE FLAVOUR THICK BEAN CURD--->劲仔酱香味厚豆干
Brookside Acai Blueberry Dark Chocolate--->BROOKSIDE蓝莓黑巧克力
TUNG FUNG ORGANIC SOY BEAN--->同丰有机黄豆
TUNG FUNG ORGANIC COIX SEED--->同丰有机薏米
Kao Liese Bubble Hair Color Cool Ash--->花王泡沫染发亚麻灰
TOPCHOICE ORGANIC RED BEAN--->超卓有机红小豆
Nitto Royal Milk Tea--->日东红茶皇家奶茶
ORION Q PEDICLE HAZELNUT CHOCOLATE CAKE--->好丽友榛子巧克力Q蒂蛋糕
TIGER MICOM RICE COOKER JBVS18U 10 CUPS--->虎牌10杯电锅JBV-S18U
Gilim Honey Butter Cashew Nut--->GILIM蜂蜜黄油腰果
MIDEA ELECTRIC RICE COOKER 5.5 CUPS--->美的5.5杯电饭煲
GLICO POCKY FUKAMI GREEN TEA BISCUIT STICK--->固力果浓抹茶百奇
KOPIKO CAPPUCCINO--->KOPIKO牛奶咖啡
PENGSHENG PRESERVED OLIVE VEGETABLE--->蓬盛橄榄菜
Saborino Morning Face Mask--->SABORINO早安面膜
Cow Bouncia Elegant Rose Body Wash--->牛牌玫瑰芬芳沐浴露
Ryoe Herbal Hair Dye 7O Orange Brown--->吕植物染发剂7O橙棕
Kao Laurier Soft Overnight Sanitary Pads 40Cm--->花王蕾妮亚素肌棉柔卫生棉40CM
Luobawang Spicy Liuzhou Rice Noodle--->螺霸王麻辣螺狮粉
HADAY COOKING WINE--->海天料酒
SAMYANG HOT CHICKEN 2X SPICY FRIED RAMEN--->三养2X特辣乾面
SAMYANG HOT CHICKEN STEW RAMEN--->三养辣鸡汤面
LIUPO FRIED PEPPER SAUCE--->六婆油泼辣子
SATO DEMAX A TOOTHPASTE--->佐藤牙龈适盐味牙膏
MES Hello Bubble Foam Color - Dusty Ash (6A)--->爱茉莉美妆仙植物泡沫染发烟灰色
T&T Alloy Chopsticks Snake Skin 5 Pairs--->T&T合金筷蛇纹5对
YIJIANGNAN TIEGUANYIN OOLONG TEA--->忆江南铁观音
YIJIANGNAN PU ERH TEA--->忆江南普洱茶
HUAI LIAN ONION & PORK RIBS YAM CHIPS--->怀恋香葱排骨薄片
KUAIJISHAN SHAOXING COOKING WINE--->会稽山12年花雕酒
Lee Kum Kee Organic Premium Soy Sauce--->李锦记有机头抽
Sgyj Donkey Hide Gelatin Cake--->上古阿胶糕
CHACHA CHINESE PECAN FLAVOUR SUNFLOWER SEEDS--->洽洽山核桃味瓜子
DIANE WHITE FLORAL BRIGHTENING BODY WASH--->黛丝恩淡雅白花美白沐浴露
MASTERKON SHRIMP&FISH NOODLE--->康师傅鲜虾鱼板面
MASTERKON ROASTED BEEF NOODLE--->康师傅红烧牛肉面
DASHANHE DRIED BAMBOO FUNGUS--->大山合福建竹荪
Jayjun Anti-Dust Therapy Mask--->JAYJUN净化镇定面膜
WANGSHOUYI CHINESE PEPPER SEASONING--->王守义花椒
Jm Solution Honey Luminous Royal Propolis Mask--->JM SOLUTION水光蜂蜜面膜
LIUQUAN SELF-HEATING SPICY RICE NOODLE--->柳泉自热螺狮粉
Wujiang Mild Spicy Preserved Vegetable--->乌江微辣榨菜
TAMANOHADA LIQUID BODY WASH 002 MUSK--->玉肌沐浴露002麝香
Sunity Oats & Milk Herbal Jelly--->生和堂奶麦龟苓膏
JIAFULI HICKORY NUT FLAVOUR PEANUTS--->嘉福利山核桃珍珠花生
Viva Sugar-Free Cashew & Purple Rice Drnk--->万岁腰果紫米坚果饮
Jm Solution Water Luminous S.O.S Ringer Mask--->JM SOLUTION水光针剂急救面膜
Lanfongyuen Milk Tea--->兰芳园奶茶
JINZAI SPICY & HOT LITTLE FISH--->劲仔香辣小鱼
JINZAI SICHUAN STYLE LITTLE FISH--->劲仔麻辣小鱼
JEAN FU ORIGINAL PREPARED SHREDDED SQUID--->珍福珍好原味鱿鱼丝
LIUSHEN FLORIDA WATER MOSQUITO REPELLENT--->六神驱蚊花露水
BLUE DIAMOND BBQ BOLD ZESTY ALMOND--->蓝钻石烧烤杏仁
GREAT MOUNTAIN LARGE SHORT GINSENG--->大山行长枝花旗蔘
Dong Ming Da Qiao Sugar--->东明大桥绵白糖
Kuki Roasted Black Sesame Seed--->九鬼日本炒黑芝麻
SUN KUNG VACUUMBOX--->三光真空饭盒
Panasonic Nanoe Hair Dryer Ehna65--->松下纳米护发风筒
JULIANG ROASTED BLACK SESAME SEED--->巨量野生黑芝麻熟
KIM ROCK SUGAR GENUINE BIRDS NEST DRINK--->金羽燕冰糖燕窝饮
Organic Dried Black Fungus--->有机黑木耳
T&T Coconut Cream--->T&T 椰浆
NONGSHIM CHAPAGETTI--->农心炸酱面
Taokaenoi Sriracha Chilli Crispy Seaweed Snack--->小老板泰式口味脆紫菜
T&T Shanxi Style Noodle--->T&T 山西刀削面
KIKKOMAN ORGANIC SOY SAUCE--->万字有机酱油
KIKKOMAN SOUP BASE--->万字浓汤汁
Snp Black Pearl Ampoule Mask--->SNP 黑珍珠安瓶面膜
WU-MU LANZHOU STYLE NOODLE--->五木袋装兰州拉面
PACIFIC INTL BLACK MOSS--->太平洋发菜
VITA HONEY LEMON TEA--->维他蜂蜜柠檬茶
Naturie Hatomugi Skin Conditioner Lotion--->NATURIE薏仁保湿化妆水
MARUTAI KURUME TONKOTSU NOODLE--->丸太久留米豚骨面
MARUTAI KUMAMOTO BLACK OIL NOODLE--->丸太熊本油面
T&T Dried White Shiitake Mushroom--->T&T 庆元白花菇
T&T DRIED TEA TREE MUSHROOMS--->T&T 茶树菇
WEI-LONG KISS BURN SPICY BEEF FLAVOUR GLUTEN--->卫龙牛肉亲嘴烧
DMDQ DRIED SEAWEED--->东明大桥野生紫菜
UHA 100% JUICE GRAPE GUMMY--->味觉果汁100%葡萄Q糖
GOLDEN NEST SWALLOW NEST BEVERAGE--->金燕窝无糖燕窝
Lantic Granulated Sugar--->LANTIC细砂糖
WHITE RABBIT CREAM PRUNE DROPS CANDY--->大白兔奶油话梅糖
T&T Beech Wood Stir Fry Spatula--->T&T 榉木铲
DASHANHE DRIED WHITE SHITAKE MUSHROOM--->大山合切足白花菇
T&T ALLOY CHOPSTICKS 2 PAIRS--->T&T合金筷2对
Dmc Deep Cleansing Mask--->DMC 黑里透白冻膜
FULINMEN DAOHUAXIANG RICE--->福临门稻花香大米
T&T Sweet Potato Wide Vermicelli--->T&T韩式红薯宽粉(宽)
SOFY HERBAL COTTON SANITARY PAD 21CM--->苏菲贵爱娘中草药纯棉卫生棉21CM
SOFY HERBAL COTTON SANITARY PAD 25CM--->苏菲贵爱娘中草药纯棉卫生棉25CM
Dashanhe Bamboo Shoot--->大山合嫩笋尖
Ahc Premiun Hydra B5 Soother Mask--->AHC B5补水面膜
Dr.Jart Soothing Hydra Solution--->DR.JART舒缓补水面膜
NISSIN BEEF CUP NOODLE--->合味道牛肉杯面
H&H THAI PREMIUM MIX DRIED FRUITS--->H&H 泰国干果
MERILIN SOUTH DRIED ALMOND SEED--->美林南杏
Christie Original Ritz--->丽斯原味饼
Terra Delyssa Extra Virgin Organic Olive Oil--->TERRA DELYSSA有机特纯橄榄油
MAPLELIFE GOLDEN ALASKA DEEP SEA FISH OI--->美宝莱深海鱼油
T&T Pure Corn Oil--->T&T 纯粟米油
CANGHONG SWEET DATES WITH EIJAO--->沧宏甜枣阿胶枣
LUHUA FIRST-CLASS PEANUT OIL--->鲁花一级花生油
EMF PLATE PICK--->EMF 万能钳
WANT WANT ORIGINAL SEAWEED RICE CRACKERS--->旺旺厚烧海苔
T&T CREAM STYLE CORN--->T&T 粟米汤
NESCAFE SWEET & CREAMY COFFEE--->雀巢香甜奶油咖啡
Mise En Scene Hb 5Br Deep Bordeaux Rose--->美妆仙植物泡染发-酒红
Meiji Strawberry Giant Hello Panda--->明治草莓熊猫饼干
Shu Ke Xing Self-Heating Bbq--->蜀客行自热西昌烧烤
Tamanohada Musk Conditioner 002--->玉肌无硅护发素02-麝香
Wgdc Cheese Noodles 5 Pk--->五毂道场芝士拉面五包
GLICO HAZELNUT CHOCO COOKIES--->榛仁巧克力百醇
SHUN SAVORY MUSHROOM FLAVOR NOODLE--->顺香春香菇叁鲜拌面
Wugudaochang Tomato Beef Instant Noodle--->五谷道场番茄牛腩面
SAFETY GLASSES--->防护眼镜
KUAI KUAI CORN BISCUIT-FIVE SPIC--->乖乖五香玉米脆条
BALIS BEST COFFEE CANDY--->芭里咖啡糖
BB BREAD TWIST W/BROWN SUGAR--->鑫豪黑糖蜜麻花
DZ WIDE TYPE BEAN VERMICELLI--->帝珠火锅宽粉
HHC CORN CRACKER--->嗄嗄叫关东串烧栗
MORINAGA BUTTER MOONLIGHT COOKIES--->森永鸡蛋牛油曲奇
EL HALL MANGOSTEEN CANDY--->恩泽罗汉果枇杷糖
GLICO WHEAT GERM BISCO BISCUIT--->日本固力果麦芽乳酸饼
LOTTE BANANA CHOCO PIE--->乐天香蕉巧克力派
MEIJI CHOOCLATE HELLO PANDA--->明治朱古力小熊猫
MEIJI STRAWBERRY HELLO PANDA--->明治草莓小熊猫
Chupachups Mixed Fruit Lollipop--->珍宝珠什果棒棒糖
CL MAHOGANY ORGANIC HERBAL HAIR COLOR--->CL红褐纯植物染发剂
DANDAN GREEN PEPPER FISH SEASONING--->丹丹青花椒鱼调料
DANDAN SPICY FISH SEASONING--->丹丹水煮鱼调料
LITTLE SHEEP HOT POT SOUP BASE--->小肥羊羊汤调味料
HENG XING LESS SALT BEAN SAUCE--->恒星薄盐酱香豆瓣
JULIANG SOYBEAN SAUCE--->巨量非转基因黄豆酱
LSJ BEEF XIAN INSTANT BREAD IN SOUP--->老孙家牛肉西安泡馍
LSJ LAMB XIAN INSTANT BREAD IN SOUP--->老孙家羊肉西安泡馍
SILVAT WOODEN IH FRYPAN 28CM--->SILVAT IH不粘煎锅28
KOKUHO BROWN RICE--->国宝糙米
ROBIN HOOD FLOUR ALLPURPOSE--->罗宾汉多用途面粉
PRESERVED BLACK BEANS--->珠江桥阳江豆豉
INDONESIAN FRIED RICE HOT INDOFOOD--->印尼炒饭调味料
RENDANG BEEF IN HOT SAUCE--->印尼辣牛肉调味料
SAPORITO VEGETABLE OIL--->SAPORITO 菜油
YU YUAN PRESERVED CHNS CABBAGE--->榆园酸白菜
SAPORITO CANOLA OIL--->SAPORITO芥花油
POR KWAN SATAY PEANUT SAUCE--->珀宽沙爹花生酱
KINGO CORN FLOUR--->金谷玉米面
KINGO BROWN JASMINE RICE--->金谷茉莉糙米 2KG
CHIMES GARDEN THAI ORGANIC TRIO MIX RICO--->随园有机泰原三宝米
PRESIDENT CHOICE LIQUID COCONUT OIL--->PC纯椰子油
JULIANG ORGANIC CORN MEAL--->巨量有机玉米面
PRB PRESERVED BEANS WITH GINGER--->珠江桥阳江姜豉
MASTERKON SPICY BEEF INSTANT NODLE--->康师傅新香辣牛肉
YOUJIA SPICY HOT NOODLES CONDIMENT--->友加麻辣面调料
KLEANNARA COTTON SANITARY PAD 23CM--->KN纯棉日用23CM
JULIANG ORGANIC CARGO RICE--->巨量有机红糙米
BIGEN DARK BROWN ONE PUSH #5--->美源棕色OP#5
SHIBAZI MULTI-FUNCTION PEELER--->十八子厨房多用刨
EMF CHOPPER STAINLESS STEEL BONING CHOPPER--->不锈钢胶柄砍骨刀
EMF KOREAN MINI EARTH POT--->EMF陶瓷韩式汤锅
Asd Iron Stir Fry Pan 32Cm--->爱仕达精铁炒锅32CM
Asd Iron Stir Fry Pan 30Cm--->爱仕达精铁炒锅30CM
3 TIERS STAINLESS STEEL STEAMER 30CM--->三层蒸锅30CM
PORTO DIAMOND COATING NONSTICK WOK 34CM--->PORTO 钻石不粘炒锅34CM
Queen Art Inoble Coating Nonstick Wok 30Cm--->韩国QUEEN ART大理石不粘炒锅30CM
QUEEN ART INOBLE COATING NONSTICK WOK 28CM--->韩国QUEEN ART大理石不粘炒锅28CM
Queen Art Marble Coating Nonstick Wok 34Cm--->韩国QUEEN ART石纹不粘炒锅34厘米
Queenart Granite Ceramic Coating Nonstick Wok 30Cm--->韩国QUEEN ART花岗纹陶瓷不粘炒锅30CM
Supor Casting Iron Stir Fry Pan 32Cm--->苏泊尔铁炒锅32CM
SUPOR CASTING IRON STIR FRY PAN 30CM--->苏泊尔铁炒锅30CM
EPAN CERAMIC SOUP POT--->一品陶汤煲
Porto Diamond Coating Nonstick Fry Pan 28Cm--->PORTO钻石不粘煎锅28CM
AP MULTI SIZE PAN COVER--->AP多用不锈钢锅盖
EMF CWK WOK GLASS COVER 32CM--->EMF玻璃盖
Queen Art Marble Coating Nonstick Wok 32Cm--->韩国QUEEN ART石纹不粘炒锅32厘米
Queen Art Marble Coating Nonstick Wok 30Cm--->韩国QUEEN ART石纹不粘炒锅30CM
QUEEN ART MARBLE COATING NONSTICK FRY PAN 28CM--->韩国QUEEN ART石纹不粘煎锅28CM
QUEEN ART MARBLE COATING NONSTICK FRY PAN 24CM--->韩国QUEEN ART石纹不粘煎锅24CM
EMF COOKWARE GI. COVER 30CM--->EMF 玻璃盖
SUNWEALTH STEAMER POT 24CM--->新康日式蒸锅
SS GLASS LID POT 18X10.5CM--->不锈钢玻璃盖煲
SS GLASS LID POT 16X9.5CM--->不锈钢玻璃盖煲
SS GLASS LID POT 20X15CM--->不锈钢玻璃盖煲
THERMAL COOKER 4.-CARRY OUT--->膳魔师焖烧锅
Mengniu Milk-Peach Flavour--->蒙牛真果粒-黄桃口味
SHUANG QIAN PEAR LOQUAT JELLEY--->SHUANG QIAN PEAR LOQUAT JELLEY
Kirin Gogono Koucha Lemon Tea--->午後红茶柠檬茶
10 IN BAMBOO SKEWERS--->10 IN BAMBOO SKEWERS
T&T WHITE PEPPER POWDER--->T&T白胡椒粉
SHIZUOKA MATCHA (GREEN TEA) PR--->静冈抹茶综合饼干
PROAD HOKKAIDO KOIGASANE--->北海道恋人白巧杏仁饼
PROAD HOKKAIDO WHITE CHEESE CAKE--->北海道恋人雪纺蛋糕
MIZKAN TONKOTSU SOUP BASE--->味滋康猪骨锅汤底
Staub Cast Iron Cocotte Round 3.8L--->STAUB铸铁锅红 3.8L
ICHIEI CHEESE SCALLOP SNACK--->日本一荣芝士帆立元贝
KAMEDA HONOKAORI 10 RICE CRACKER--->龟田穗香米果礼盒
SHOEI MILK CUSTARD PIE COOKIE BOX--->日本伊索北海道牛乳派
PORORO 3D SPOON FORK 2P--->PORORO 3D SPOON FORK 2P
KOMAX LOOK GLASS REC 880ML--->KOMAX LOOK GLASS REC 880ML
TIGER SS DIRECT DRINK MUGS LARGE--->TIGER SS DIRECT DRINK MUGS LARGE
NO NAME BRIQUETS--->NN烧烤碳
Taisun Mixed Brown Sugar Congee--->泰山黑糖八宝粥
LZQ LOTUS ROOT POWDER GIFT BOX--->李子柒桂花坚果藕粉礼盒（藕粉350g*2，锤目纹小碗*1，刻字木勺*1、木制封口夹*1）
Golden Elephant Jasmine Rice--->金象香米
MSZW HOKKAIDO CAMEMBERT CHEESE CAKE--->MS北海道芝士蛋糕
Calbee Potato Chips--->卡乐B薯条三兄弟
GLICO POCKY CHOCO BANANA BISCUIT STICK--->固力果巧克蕉百奇
PROAD HOKKAIDO CHEESE CAKE--->北海道恋人芝士蛋糕
T&T Dot Pattern Steel Chopsticks--->T&T波点不锈钢筷
Lkk Sesame Sauce--->李锦记芝麻酱
HDL SPICY BEEF SELFHEAT HOTPOT--->海底捞麻辣嫩牛火锅
Nissin Sesame Oil Ramen Noodle--->日本出前一丁麻油面
Suntory Boss Milk Tea--->三多利BOSS奶茶
Genki Forest Jasmine Green Milk Tea--->元气森林茉香绿奶茶
Sh 2Yolks Lotus Mooncake--->圣安娜双黄莲蓉月饼
LIPTON BRITISH MILK FLAVOR TEA--->立顿英式奶茶
Lays Mexican Salsa Sauce Potato Chips--->乐事墨西哥酸辣酱薯片
Lays Wei-Wei A Chicken Flav. Potato Chip--->乐事味味A排骨鸡面薯
Lays Bbq Beef Flav. Potato Chips--->乐事烤肉牛五花味薯片
Lays Original Flav. Potato Chips--->乐事喀脆原味大波浪
Shinho Soy Sauce--->欣和六月鲜促销装
Timu Farm Taiken 9 White Rice--->田牧信粮台梗九号米
Robotime Blind Box--->国潮盲盒
Kee Wah Almond Biscuits Gift Box--->奇华杏仁饼礼盒(阿虫)
Moegino Assorted Cookies 60Pcs--->千本薄烧酥礼盒60枚
Mei-Xin Original Petiti Egg Roll--->美心原味精致蛋卷
Silvat Wooden Ih Pot With Lid 20Cm--->SILVAT不粘汤锅有盖20CM
Silvat Wooden Ih Pot With Lid 18Cm--->SILVAT不粘奶锅有盖18CM
Lays Suger Taste Potato Chips--->乐事大白兔味薯片
Happy Bath Grapefruit Body Wash--->HB清爽西柚沐浴露
Yiling Lianhua Qingwen Capsule--->以岭莲花清瘟胶囊
BAIJIA PEPPERY CHICKEN SEASONING--->BAIJIA PEPPERY CHICKEN SEASONING
Ji Xiang Ju Salted Stem Mustard--->吉香居榨菜真芯
OYATSU SPICY NOODLE SNACK--->OYATSU SPICY NOODLE SNACK
Tkn Big Roll Grilled Seaweed Value Pack--->小老板烤紫菜卷家庭包
Lipton Milk Flv Green Tea--->立顿萃香奶绿
HOUSE MED HOT MABO TOFU SAUCE--->HOUSE MED HOT MABO TOFU SAUCE
Happy Bath Magnolia Body Wash--->Happy Bath木兰花沐浴露
Kings Noodle Hot & Spicy Noodle--->金牌干溜重庆小面
Lfy Hk Style Coffee With Tea--->兰芳园港式鸳鸯
Rf Bubble Milk Tea Flav Mochi--->皇族珍珠奶茶大福
Lays Grilled Wings Yam Chips--->乐事烤翅味山药薯片
By Orient Multi Electric Skillet--->东枋多功能电子炉
NISSIN BLK PEPPER CRAB CUP NOODLE--->合味道黑椒蟹杯面
PRIMA TASTE RENDANG DRY CURRY--->百胜厨亚洲干咖哩
HOUSE WASABI PASTE--->屋牌日本芥末酱
SHIMAYA DASHINOMOTO KATSUO--->柴鱼调味粉
NISSIN SEAFOOD INSTANT NOODLE (5PACK)--->出前一丁海鮮5 包
Denroku Mix Rice Cracker--->殿六什锦米果
CHUN SI SHANGHAI STYLE NOODLE--->春丝上海阳春面
DR.MORITA HYALURONIC ACID MOISTURIZING FACE WASH--->森田玻尿酸保湿洗面乳
Dr.Morita Hyaluronic Acid Mask--->森田玻尿酸面膜
SOFY UNSCENTED PANTY LINERS--->苏菲轻柔护垫无味
YEJIMIIN MILD HERB COTTON SANITARY PAD 23CM--->YEJIMIIN草本棉面卫生棉23CM
T&T SWEET RICE--->T&T 美国圆糯米
Maling Luncheon Meat--->上海梅林午餐肉
KAKIEN AOYANAGI GREEN TEA--->青柳高级日本绿茶
GOLDEN BONBON ASSORTED ALMOND NOUGAT CANDY--->加宝什锦鸟结糖
Bigen Speedy Hair Color Light Chestnut--->美源发采柔和浅栗
T&T Sesame Biscuit Egg Roll--->T&T 芝麻蛋卷
Kracie Hadabisei Tightening Black Mask--->葵缇亚肌美精深层紧致面膜
Nissin Xo Sauce Seafood Cup Noodle--->合味道XO酱海鲜面
JACK & JILL V-CUT BBQ POTATO CHIPS--->JACK & JILL 烧烤味薯片
NONGSHIM BEEF BONE SPICY CUP NOODLE BLACK--->农心牛骨辛辣杯面
UHA 100% JUICE MUSCAT GUMMY--->味觉果汁100%青提Q糖
THREE SQUIRRELS LEATHEROID WALNUTS--->三只松鼠纸皮核桃
Three Squirrels Original Pine Nuts--->三只松鼠原味松子
Ryoe Hair Loss Repairing Set For Oily Scalp--->吕防脱生发油性头皮洗护套组
QUALITY FIRST QUEENS BRIGHT MASK--->QUALITY FIRST女王亮白面膜
TIC TAC FRUIT ADVENTURE--->TIC TAC杂果味糖
PROPOLINSE SAKURA MOUTHWASH--->PROPOLINSE樱花漱口水
WANT WANT SPICY FRIED RICE SNACK--->旺旺一定要吃辣味
Yijiangnan Jasmine Green Tea--->忆江南茉莉绿茶
SUNNYMARK GARLIC FRIED FISH SKIN--->新唛蒜味香脆鱼皮
DIANE TIARA FLORAL MOIST BODY LOTION--->黛丝恩皇冠花香滋润身体乳
Vinda Wet Wipe(10 Pack)--->维达消毒湿巾10PCS
JFC KATSUO FUMI FURIKAKE--->日式 柴鱼拌饭料
Nestle Yuzu Green Tea Kitkat--->雀巢香柚抹茶奇巧
Iris Foods Rice Cake--->爱丽丝维尼熊年糕
LEE KUM KEE SRIRACHA MAYO 445ml--->李锦记是拉差蛋黄445ml
WEI-LONG HOT&SPICY STICKS--->卫龙香辣味小面筋
SUNITY PASSION FRUIT HERBAL JELLY--->生和堂百香龟苓饮
SUNITY ORIGINAL FLAVOUR HERBAL JELLY--->生和堂原味龟苓饮
UFC TAMARIND SOUP MIX--->UFC菲式酸子汤料
CHOI HEONG YUEN PHOENIX EGG ROLLS--->咀香园凤凰卷
Bigen Speedy Hair Color Natural Brown--->美源发彩自然棕
Kanebo Hot Springs Milky Bath Salts Assortment--->佳丽宝日本温泉混浊入浴剂
WANT WANT CHEESE RICE CRACKER--->旺旺芝士米果
On Kee Braised Abalone In Scallop And Oyster Sauce--->安记4头吉品鲍鱼
Jacquot Classic Truffles--->JACQUOT经典松露巧克力
Gh Sesame Oil Fermented Tofu--->广合白腐乳
Sofy Happy Day Sanitary Pad 26Cm--->苏菲猫咪日用26cm
Royal Family Bubble Milk Tea Flavour Cake--->皇族珍珠奶茶酥礼盒
Wugudaochang Tonkotsu Flavour Ramen 5Pk--->五谷道场日式豚骨面
GLICO FLAMBOISE PISTACHIO CHOCO SNACK--->GLICO红莓开心果百奇
HFC NOUGAT CANDY--->徐福记牛轧糖
KOLOKO PEA CRACKERS-BASIL--->可乐果豆酥-九层塔
HAORENJIA PICKLED PEPPER FISH FLAVOR--->好人家泡椒麻鱼调料
KENKO GARLIC BUTTER SAUCE--->KENKO蒜香牛油汁
IDF RENDANG BEEF/CHLICCNT SEASOING--->椰汁辣牛肉料
T&T Wasabi Paste In Tube--->T&T 芥末酱(管装)
GOLDEN NEST HONEY TERIYAKI PORK JERKY--->金燕窝蜂蜜照烧猪肉乾
LIU LIU MEI PRESERVED GREEN PLUM--->溜溜梅原青梅
Nestle Strawberry Daifuku Kitkat--->雀巢草莓大福奇巧
Nittoh Kocha Sakuraq Instant Milk Tea--->日东红茶樱花速溶奶茶
WS BROWN SUGAR--->维生顶级黑糖
NS SHANGHAI CUP NOODLE-SPICY MUSHROOM--->农心上海杯面香菇
SAPPORO ORIGINAL RAMEN 5 PACK--->一番原味拉面 5包装
JFC SALMON FURIKAKE SAKE FUMI--->JFC三文鱼拌饭料
Chahua Net Sponge--->茶花网布海绵刷片
HADALABO GOKUJYUN HYALURONIC MOIST LOTION--->肌研极润玻尿酸保湿化妆水
Soo Singapore Street Style Pork Jerky--->狮牌新加坡猪肉乾
On Kee Braised Abalone In Oyster Sauce 6Pc--->安记顶级黄金鲍鱼6头
Royale Tiger Towels 6 Rolls--->萝雅莉厨用纸6卷
AJI MIRIN--->味醂
SHJ PUMPKIN SEEDS--->盛香珍南瓜子
LEE KUM KEE CHILI OIL--->李锦记辣椒油
AROY-D JACKFRUIT IN SYRUP--->阿罗地糖水菠萝蜜
SHIRAKIKU ROASTED WHITE SESAME SEED--->白菊印烧芝麻
LKK SATAY SOUP BASE/HOT POT--->李锦记沙爹火锅汤
LEE KUM KEE SWEET&SOUR SPARE RIBS SAUCE--->李锦记甜酸排骨酱
MARUKIN UJI GREEN TEA CAKE--->丸金宇治抹茶小蛋糕
Tapioca Pearls (Large)--->如意牌西米(大)
Otafuku Yaki Soba Sauce--->多福日本炒面汁
T&T Pattern Bamboo Chopsticks 5 Pairs--->T&T 花开富贵竹筷5对
FANSAOGUANG PRESERVED BAMBOO SHOOT--->饭扫光即食野竹笋
Taisun Mix Black Glutinous Rice Congee--->泰山紫米薏仁粥
TUNG FUNG ORGANIC PEANUT--->同丰有机花生仁
ORION BBQ POTATO CRACKERS--->好丽友好多鱼烧烤
Glico Pocky Cookies & Cream Biscuit Stick--->固力果朱古力曲奇百奇
QUALITY FIRST QUEENS SUPER MOIST MASK--->QUALITY FIRST女王超保湿面膜
QUALITY FIRST QUEENS MASK TIGHTENING--->QUALITY FIRST女王紧致面膜
AHC PREMIUM PHYTO COMPLEX CELL MASK--->AHC 胶原紧肤面膜
HAPPY BATH ROSE ESSENCE BODYWASH--->HAPPY BATH玫瑰精华沐浴露
SAU TAO BUCKWHEAT SLICED NOODLE--->寿桃荞麦刀削面
Taichung Brown Sugar Sun Cake--->太阳堂黑糖太阳饼
Nissin Tonkotsu Ramen--->出前一丁猪骨棒丁面
GREENMAX FLAXSEED & ADZUKI RED BEAN CEREAL--->马玉山亚麻红豆饮
JUTSUXIAN SPICY SEAFOOD & SCALLOP SAUCE--->菊之鲜海鲜干贝酱
Nissin Dried Noodle Soy Sauce--->日清酱油拉面王
Sofy Happy Day Sanitary Pad 23Cm--->苏菲猫咪日用23cm
ASIAN HOME GOURMET VIET PHO BEEF NOODLE--->佳厨越南河粉汤酱
Haday Spice Soybean Sauce--->海天辣黄豆酱
LKK SEAFOOD SOUP BASE/ HOT POT--->李锦记海鲜火锅汤
FARMER ROASTED PEANUTS--->农夫牌烤花生
Kanebo Hot Springs Clear Bath Salts Assortment--->佳丽宝日本温泉透明入浴剂
FITA CRACKER--->飞达饼乾
LEADERS AQUARINGER HYDRATION MASK--->丽得姿冰河保湿面膜
T&T Pattern Bamboo Chopsticks 6 Pairs--->T&T欢乐竹筷6对
JAYJUN COLLAGEN SKIN FIT MASK--->JAYJUN干细胞水光面膜
Ag Ultimate Ocean Mask Gold Repair--->AG抗糖化修护面膜
HAO HUAN LUO SPICY RICE NOODLE 300G--->好歡螺螺獅粉300G
JIYANGXUAN LIUZHOU SPICY RICE NOODLE--->寄杨轩柳州螺蛳粉
DAO XIANG CUN SALTED SHALLOT FRIED DOUGH TWIST--->稻香村香葱咸麻花
T&T TOMOSHIRAGA SOMEN NOODLE--->T&T 友白发素面
Kingo Beancurd Roll--->金谷牌响铃卷
Sunity Split Pea & Milk Herbal Jelly--->生和堂奶豆龟苓膏
Iris Foods Rice Cake--->爱丽丝迪士尼卡通年糕
ORION SEAWEED POTATO CRACKERS--->好丽友好多鱼海苔
Bigen One Push Cream Color #6 Darkest Brown--->美源按压染发剂深棕
DIANE TIARA FLORAL MOIST BODY WASH--->黛丝恩皇冠花香滋润沐浴露
XIAOLONGKAN SELF-HEATING VEGETABLE HOT POT--->小龙坎自煮火锅素
LEADERS TEA TREE RELAXING SKIN RENEWAL MASK--->丽得姿茶树油舒缓面膜
Soo Singapore Street Style Beef Jerky--->狮牌新加坡牛肉乾
APPLE SIDRA DRINK--->苹果西打
Taokaenoi Spicy Tempura Seaweed--->小老板辣味天妇罗
VINACAFE INSTANT COFFEE MIX--->3合1越南咖啡
DETTOL ANTI-BACTERIAL BAR SOAP--->滴露杀毒抑菌香皂
LE GOURMET HRRDWOOD LUMP CHARCOAL--->LE GOURMET烧烤碳
LKK VEGT MUSHROOM STIR-F SAUCE--->李锦记香菇素蚝油
MARUTO BANANA CASTELLA CAKE--->丸卜半熟香蕉蛋糕
ONTRUE DRIED BEANCURD STRIPS--->安厨石屏豆腐丝
Tong Yi Borscht Flavor Noodle--->统一罗宋汤碗面
Yj Panty Liner Herb 40P--->YJ草本护垫40片
South Word Yellow Crystal Sugar--->南字单晶冰糖
MARUTO MACCHA LANGUE-DE-CHA--->丸卜抹茶白巧夹心饼
Wgdc Inst Ndle- Braised Beef--->五谷道场红烧牛肉
XIABUXIABU HOT POT BASE (MUSHROOM)--->呷哺松茸菌火锅料
SUNBROWN GLUTEN FREE CARLOSE BROWN RICE--->新宝非基因糙米
PEARL RIVER BRIDGE SPICY FERMENTED BEAN--->珠江桥牌辣白腐乳
LKK SEASONED SOY SAUCE FOR SEAFOOD--->李锦记蒸鱼豉油
Energy Green Pepper Vermicelli--->食族人藤椒粉
Erawan Rice Stick (L)--->三象炒河粉(粗)
Jfc Noritamago Furikake--->JFC海苔鸡蛋拌饭料
AROY-D GREEN CURRY PASTE--->阿罗地绿咖喱胶罐
Hung Fook Tong Ginseng Chrysanthemum Honey Drink--->鸿福堂菊花蔘蜜
KJB RICE BIN--->康家宝长方米桶
HOUSE WASABI TUBE FAMILY SIZE--->屋牌山葵酱
KIKKOMAN ORIGINAL TERIYAKI SAUCE--->万字原味照烧酱
Taokaenoi Original Tempura Seaweed--->小老板原味天妇罗
Sau Tao Scallap Noodle-Thick--->寿桃特级瑶柱宽面
Southern Black Sesame Gift Box--->南方黑芝麻糊礼盒
DANISA PINEAPPLE FILLED COOKIE--->皇冠菠萝注心曲奇
HAPPY BATH LAVENDER ESSENCE BODY--->HAPPY BATH薰衣草精华沐浴露
DAN-D-PAK SEA SALT FANCY NUT MIX--->丹蒂海盐杂锦果仁
INDOMIE HOT&SPICY INST FRIED NDL--->营多印尼麻辣炒面
Nissin Seafood Big Cup Noodles--->合味道海鲜大杯面
CHUN SI SICHUAN DAN DAN NOODLE--->春丝四川担担面
MIZKAN MITSUKAN SWEET MIRIN--->味滋康日本甜味醂
JFC SETO FUMI FURIKAKE RICE SEASONING--->日本濑户拌饭料
S&B Golden Medium Hot Curry--->S&B中辣金装咖哩
CHIN-KEE EGG ROLL--->精记蛋卷
JFC INSTANT NAMA UDON CUP--->JFC即食杯装乌冬
BAIJIA BOILED FISH IN HOT CHILI OIL--->白家沸腾鱼调料
Ryoe Hair Loss Repairing Mask--->吕防脱生发修护发膜
LARBEE WHITE PANDA JELLY--->蜡笔小新白熊果冻
GILIM HONEY BUTTER MACADAMIA--->GILIM黄油夏威夷果
RYUKAKUSAN STRENGTHEN HERBAL THROAT CANDY--->龙角散特效草本喉咙糖
THERMOS STAINLESS STEEL VACUUM WATER PUMP POT--->膳魔师保温热水壶
Ishiyaseika White&Black Chocolate Cookie--->白色恋人黑白巧克力
Samyang Carbonara Spicy Chicken Rice Cake--->三养芝士辣鸡炒年糕
Jinshahe Lz Noodel Addfree--->金沙河无添加拉面
Purederm Hygienic Wipes 20S--->PD酒精杀菌湿巾20S
Wgdc Chopped Hot Pepper Instant Noodles--->五谷道场剁椒鱼头
PK CONCENTRATE TAMARIND--->珀宽酸子酱料
LEE CRAB PASTE--->李牌蟹膏
Hagoromo Shoyu Mackerel--->羽衣酱油鲭鱼
Taokaenoi Big Seaweed Roll - Tom Yum Goong Flavour--->小老板辛辣紫菜卷
T&T BUCKWHEAT SOBA NOODLES--->T&T 荞麦面
S&B SHICHIMI ASSORTED CHILI PEPPER--->SB 七味辣粉
PRB RICE STICK--->帆船牌江门排粉
FSG CRISP BLACK FUNGUS--->饭扫光爽脆木耳
Royale Velour 30Dr60(Limit 1 Per order)--->萝雅莉白猫奢柔30D60(每單限購一件）
LEE KUM KEE SAUCE FOR TERIYAKI CHICKEN--->李锦记照烧鸡翼酱
Little Sheep Original Dipping Sauce--->小肥羊清香火锅蘸料
AROY-D CANNED GREEN CURRY--->阿罗地即食青咖哩
JFC WASABI FUMI FURIKAKE--->日式芥辣拌饭料
Nissin Tom Yum Cup Noodles--->日清合味道冬阴功杯面
LUCKY ME SUPREME CUP PINOY CHICKEN--->幸运菲鸡肉碗面
KAKIEN MACCHA GREEN TEA POWDER--->极品绿茶粉加绿茶
TONGXIANG PRESERVED TANGERINE PEEL--->同享九制陈皮
SENSODYNE ULTRA FRESH TOOTHPASTE--->舒酸定清新牙膏
Lb Maple Maple Black Tea--->LB MAPLE枫叶红茶包
JINMAILANG THIN RAMEN NOODLE--->今麦郎手打拉面
WAN JA SHAN VEGETARIAN MUSHROOM OYSTER SAUCE--->万家香香菇素蚝油
CHOI HEONG YUEN EGG ROLLS--->咀香园鸡蛋卷
Nissin Yakisoba Fried Noodle--->日本日清酱烧炒面
LUCKY ME SUPREME CUP BATCHOY--->幸运菲式牛肉味面
Kao Merries Baby Diaper Size L 54 Sheets--->花王纸尿布大号54片
Tsuruyaseika Sakura Pudding--->日本花之会樱花味布丁
Lee Kum Kee Pure Sesame Oil--->李锦记极纯芝麻油罐
PROPOLINSE MATCHA MOUTHWASH--->PROPOLINSE抹茶漱口水
DIANE WHITE FLORAL BRIGHTENING BODY LOTION--->黛丝恩淡雅白花美白身体乳
YIJIANGNAN DRIED ROSE--->忆江南玫瑰花茶
LIYUAN ORGANIC PEELED ROASTED CHESTNUT--->栗源有机甘栗仁
Nongshim Neoguri Seafood Noodle--->农心辣海鲜
KOSE CLEAR TURN BABYISH MOIST MASK--->高丝婴儿肌保湿面膜
Ryoe Dry Hair Ginseng Total Care Conditioner--->吕干性发质人参修护防脱护发素
Guangyou Sour Hot Instant Noodle--->光友酸辣粉碗装
MARUTO WHITE CHOCOLATE COOKIE--->丸卜浓乳白巧夹心饼
GLICO CRISP PRETZ CHICKEN FLAV. COOKIE--->固力果香酥鸡百力滋
GLICO LEMON PEACH CHOCO SNACK--->固力果柠檬蜜桃百奇
KUAI KUAI CORN BISCUIT-COCONUT--->乖乖椰子玉米脆条
DAFU MA SU TANG--->大福芝麻酥糖
SIX-F BLACK SESAME COOKIES--->六福黑芝麻糖
ASIAN HOME GOURMET SINGPR BLK PEPPER STR--->佳厨新加坡黑胡椒
OCEAN STAR SEA CUCUMBER XL--->OS圆筒海参特大
PALDO STIR KIMCHI RAMEN 134GX4--->八道泡菜先生拌面
SHARPENING ROD 12 INCH--->十八子磁力磨刀棒
Zwilling Nova 8Pc Stainless Steel Cookware--->双立人不锈钢锅具组
PORTO DIAMOND COATING NONSITCK WOK 32CM--->PORTO钻石不粘炒锅32CM
PORTO DIAMOND COATING NONSITCK WOK 30CM--->PORTO钻石不粘炒锅30CM
PORTO DIAMOND COATING NONSITCK WOK 28M--->PORTO钻石不粘炒锅28CM